Date_x,BS_Earnings Quality Score,BS_Cash and Short Term Investments,BS_Cash & Equivalents,BS_Short Term Investments,"BS_Accounts Receivable - Trade, Net","BS_Accounts Receivable - Trade, Gross",BS_Provision for Doubtful Accounts,"BS_Total Receivables, Net",BS_Receivables - Other,BS_Total Inventory,BS_Inventories - Finished Goods,BS_Inventories - Raw Materials,"BS_Other Current Assets, Total",BS_Deferred Income Tax - Current Asset,BS_Discountinued Operations - Current Asset,BS_Other Current Assets,BS_Total Current Assets,"BS_Property/Plant/Equipment, Total - Gross",BS_Buildings - Gross,BS_Land/Improvements - Gross,BS_Machinery/Equipment - Gross,"BS_Property/Plant/Equipment, Total - Net","BS_Accumulated Depreciation, Total","BS_Goodwill, Net","BS_Intangibles, Net",BS_Intangibles - Gross,BS_Accumulated Intangible Amortization,BS_Note Receivable - Long Term,"BS_Other Long Term Assets, Total",BS_Defered Income Tax - Long Term Asset,BS_Other Long Term Assets,BS_Total Assets,BS_Accounts Payable,BS_Accrued Expenses,BS_Notes Payable/Short Term Debt,BS_Current Port. of LT Debt/Capital Leases,"BS_Other Current liabilities, Total",BS_Customer Advances,BS_Discontinued Operations - Curr Liability,BS_Other Current Liabilities,BS_Total Current Liabilities,BS_Total Long Term Debt,BS_Long Term Debt,BS_Capital Lease Obligations,BS_Total Debt,BS_Deferred Income Tax,BS_Deferred Income Tax - LT Liability,"BS_Other Liabilities, Total",BS_Pension Benefits - Underfunded,BS_Other Long Term Liabilities,BS_Total Liabilities,"BS_Preferred Stock - Non Redeemable, Net",BS_Convertible Preferred Stock - Non Rdmbl,"BS_Common Stock, Total",BS_Common Stock,BS_Additional Paid-In Capital,BS_Retained Earnings (Accumulated Deficit),BS_Treasury Stock - Common,"BS_Other Equity, Total",BS_Other Comprehensive Income,BS_Total Equity,BS_Total Liabilities & Shareholders' Equity,BS_Total Common Shares Outstanding,BS_Shares Outs - Common Stock Primary Issue,BS_Treas Shares - Common Stock Prmry Issue,BS_Total Equity & Minority Interest,BS_Full-Time Employees,BS_Other Property/Plant/Equipment - Net,BS_Intangibles - Net,BS_Goodwill - Net,"BS_Accumulated Intangible Amort, Suppl.",BS_Wgt Avg Disc Rate - Operating Lease,BS_Wgt Avg Disc Rate - Finance Lease,"BS_Right-of-Use Assets-Cap.Lease,Net-Suppl.","BS_Right-of-Use Assets-Op.Lease, Net-Suppl.",BS_Contract Assets - Short Term,BS_Contract Assets - Long Term,BS_Deferred Revenue - Current,BS_Deferred Revenue - Long Term,"BS_Curr. Port. of LT Capital Leases, Suppl.","BS_Curr Port of LT Operating Leases, Suppl.","BS_Long-Term Operating Lease Liabs., Suppl.",BS_Total Current Assets less Inventory,BS_Revolving Line of Credit - Outstanding,BS_Rvlvng Line of Credit - Principal Amount,BS_Rvlvng Line of Credit - Unused Amount,BS_Net Debt Incl. Pref.Stock & Min.Interest,"BS_Tangible Book Value, Common Equity","BS_Total Long Term Debt, Supplemental",BS_Long Term Debt Maturing within 1 Year,BS_Long Term Debt Maturing in Year 2,BS_Long Term Debt Maturing in Year 3,BS_Long Term Debt Maturing in Year 4,BS_Long Term Debt Maturing in Year 5,BS_Long Term Debt Maturing in 2-3 Years,BS_Long Term Debt Maturing in 4-5 Years,BS_Long Term Debt Matur. in Year 6 & Beyond,"BS_Total Capital Leases, Supplemental",BS_Interest Costs,BS_Capital Lease Payments Due in Year 1,BS_Capital Lease Payments Due in Year 2,BS_Capital Lease Payments Due in Year 3,BS_Capital Lease Payments Due in Year 4,BS_Capital Lease Payments Due in Year 5,BS_Capital Lease Payments Due in Year 6,BS_Capital Lease Payments Due in 2-3 Years,BS_Capital Lease Payments Due in 4-5 Years,BS_Cap. Lease Pymts. Due in Year 6 & Beyond,"BS_Total Operating Leases, Supplemental",BS_Operating Lease Payments Due in Year 1,BS_Operating Lease Payments Due in Year 2,BS_Operating Lease Payments Due in Year 3,BS_Operating Lease Payments Due in Year 4,BS_Operating Lease Payments Due in Year 5,BS_Operating Lease Pymts. Due in 2-3 Years,BS_Operating Lease Pymts. Due in 4-5 Years,BS_Oper. Lse. Pymts. Due in Year 6 & Beyond,BS_Operating Leases - Interest Cost,CF_Earnings Quality Score,CF_Net Income/Starting Line,CF_Depreciation/Depletion,CF_Depreciation,CF_Deferred Taxes,CF_Non-Cash Items,CF_Unusual Items,CF_Other Non-Cash Items,CF_Changes in Working Capital,CF_Accounts Receivable,CF_Inventories,CF_Payable/Accrued,CF_Other Liabilities,"CF_Other Assets & Liabilities, Net",CF_Cash from Operating Activities,CF_Capital Expenditures,CF_Purchase of Fixed Assets,CF_Purchase/Acquisition of Intangibles,"CF_Other Investing Cash Flow Items, Total",CF_Acquisition of Business,CF_Sale of Business,CF_Sale of Fixed Assets,CF_Sale/Maturity of Investment,"CF_Investment, Net",CF_Purchase of Investments,CF_Cash from Investing Activities,CF_Financing Cash Flow Items,CF_Other Financing Cash Flow,"CF_Issuance (Retirement) of Stock, Net",CF_Repurchase/Retirement of Common,"CF_Common Stock, Net","CF_Issuance (Retirement) of Debt, Net",CF_Long Term Debt Issued,CF_Long Term Debt Reduction,"CF_Long Term Debt, Net",CF_Cash from Financing Activities,CF_Foreign Exchange Effects,CF_Net Change in Cash,CF_Net Cash - Beginning Balance,CF_Net Cash - Ending Balance,CF_Cash Interest Paid,CF_Cash Taxes Paid,CF_Net Changes in Working Capital,CF_Free Cash Flow,IS_Earnings Quality Score,IS_Revenue,IS_Net Sales,IS_Total Revenue,"IS_Cost of Revenue, Total",IS_Cost of Revenue,IS_Gross Profit,"IS_Selling/General/Admin. Expenses, Total",IS_Selling/General/Administrative Expense,IS_Research & Development,IS_Unusual Expense (Income),IS_Impairment-Assets Held for Use,IS_Other Unusual Expense (Income),IS_Total Operating Expense,IS_Operating Income,"IS_Interest Expense, Net Non-Operating",IS_Interest Expense - Non-Operating,IS_Interest/Invest Income - Non-Operating,IS_Interest Income - Non-Operating,IS_Investment Income - Non-Operating,"IS_Interest Income(Exp), Net Non-Operating","IS_Interest Inc.(Exp.),Net-Non-Op., Total","IS_Other, Net",IS_Other Non-Operating Income (Expense),IS_Net Income Before Taxes,IS_Provision for Income Taxes,IS_Net Income After Taxes,IS_Net Income Before Extra. Items,IS_Extraordinary Item,IS_Total Extraordinary Items,IS_Net Income,IS_Income Available to Com Excl ExtraOrd,IS_Income Available to Com Incl ExtraOrd,IS_Basic Weighted Average Shares,IS_Basic EPS Excluding Extraordinary Items,IS_Basic EPS Including Extraordinary Items,IS_Dilution Adjustment,IS_Diluted Net Income,IS_Diluted Weighted Average Shares,IS_Diluted EPS Excluding ExtraOrd Items,IS_Diluted EPS Including ExtraOrd Items,IS_DPS - Common Stock Primary Issue,IS_Gross Dividends - Common Stock,"IS_Impairment-Assets Held for Sale, Suppl.","IS_Other Unusual Expense(Income), Suppl.","IS_Non-Recurring Items, Supplemental, Total",IS_Total Special Items,IS_Normalized Income Before Taxes,IS_Effect of Special Items on Income Taxes,IS_Inc Tax Ex Impact of Sp Items,IS_Normalized Income After Taxes,IS_Normalized Inc. Avail to Com.,IS_Basic Normalized EPS,IS_Diluted Normalized EPS,"IS_Amort of Intangibles, Supplemental","IS_Depreciation, Supplemental","IS_Depreciation of Right-of-Use Assets,Sup.","IS_Interest Expense, Supplemental","IS_Interest Expense on Lease Liabs., Suppl.","IS_Rental Expense, Supplemental","IS_Stock-Based Compensation, Supplemental",IS_Income Taxes - Non-Recurring Tax Change,"IS_Research & Development Exp, Supplemental",IS_Normalized EBIT,IS_Normalized EBITDA,IS_Domestic Pension Plan Expense,IS_Interest Cost - Domestic,IS_Service Cost - Domestic,IS_Expected Return on Assets - Domestic,"IS_Other Pension, Net - Domestic",IS_Post-Retirement Plan Expense,IS_Interest Cost - Post-Retirement,IS_Service Cost - Post-Retirement,IS_Expected Return on Assets - Post-Retir.,"IS_Other Post-Retirement, Net",IS_Total Pension Expense,IS_Total Plan Interest Cost,IS_Total Plan Service Cost,IS_Total Plan Expected Return,IS_Total Plan Other Expense,Revenue from Business Activities - Total,Gross Profit - Industrials/Property - Total,Operating Profit before Non-Recurring Income/Expense,"Earnings before Interest, Taxes, Depreciation & Amortization (EBITDA)",Income before Discontinued Operations & Extraordinary Items,Cash & Cash Equivalents,Cash & Short-Term Investments,Total Assets,Debt - Total,Common Equity - Total,Net Cash Flow from Operating Activities,"Depreciation, Depletion & Amortization including Impairment - Cash Flow - to Reconcile",Capital Expenditures - Net - Cash Flow,Net Change in Cash - Total,Free Cash Flow Net of Dividends,"Dividend Yield - Common Stock - Net - Issue Specific - %, TTM",EPS - Diluted - excluding Extraordinary Items Applicable to Common - Total,Shares used to calculate Diluted EPS - Total,Non-GAAP Free Cash Flow - Company Reported,Gross Profit Margin - %,EBITDA Margin - %,Operating Margin - %,Income before Tax Margin - %,Income Tax Rate - %,Net Margin - %,"Free Cash Flow Yield - %, TTM","Return on Average Common Equity - % (Income available to Common excluding Extraordinary Items), TTM","Return on Average Total Assets - % (Income before Discontinued Operations & Extraordinary Items), TTM","Return on Invested Capital - %, TTM",Common Shares - Outstanding - Total,Total Debt Percentage of Total Assets,Total Debt Percentage of Total Capital,Total Debt Percentage of Total Equity,Interest Coverage Ratio,Earnings Retention Rate,Dividend Payout Ratio - %,Market Capitalization,Preferred Shareholders Equity,Enterprise Value,"Asset Turnover, TTM","Income before Tax Margin - %, TTM","Pretax ROA - %, TTM","Total Assets to Total Shareholders Equity - including Minority Interest & Hybrid Debt, Average TTM","Pretax ROE - %, TTM","Tax Complement, TTM","Earnings Retention Rate, TTM",Current Ratio,Quick Ratio,Working Capital to Total Assets,"Accounts Receivable Turnover, TTM","Average Receivables Collection Days, TTM","Payables Turnover, TTM","Average Payables Payment Days, TTM","Inventory Turnover, TTM","Average Inventory Days, TTM","Average Net Trade Cycle Days, TTM",Employment Number,재고자산회전율(비율),당기순이익(천원),매출액(천원),매출원가(천원),매출총이익(천원),영업이익(천원),영업이익증가율(YoY)(연도),운전자본증감(천원),순부채(천원),"BPS(지배, Adj.)(원/주)",BPS증가율(YoY)(비율),Free Cash Flow2(천원),부채비율(비율),부채총계(천원),유동자산(천원),이익잉여금(천원),자본금(천원),자산총계(천원),현금배당성향(%),비유동비율(천원),비유동자산(천원),EBITDA2(천원),EBITDA2마진율(비율),EBITDA2증가율(YoY)(비율),"EPS(지배, Adj.)(원/주)",EPS증가율(YoY)(비율),순이익률(비율),순이익증가율(YoY)(비율),매출액이익률(비율),매출액증가율(YoY)(연도),영업이익률(비율),CAPEX(천원),ROA(비율),ROE(지배)(비율),총자산회전율(비율),유동비율(비율),인력수,인당매출,무형자산,무형자산회전율,매입채무회전율,매출채권회전율,이자보상율,자기자본비율,인당영업이익,인당순이익,SG&A,단기투자자산,채무총계,무형자산감상비 누계,유형자산감상비 누계,Gross Investment (GI),ROGI(%),EBIT(천원),투자비 대비 매출 (Rev/GI),Opex Margin,Y1,Y2,Y3,Y4,인당매출s,무형자산회전율s,인당영업이익s,인당순이익s,투자비 대비 매출 (Rev/GI)s
2007-03,86.0,0,0,0.0,373,376.0,-3.0,375,2.0,39,20,19,86,77.0,214.0,9.0,500,221.0,50.0,8.0,163.0,66,-155.0,90,64.0,15.0,-3.0,91.0,278,253,25,998,54,62,0,45.0,303,253,58.0,50,419,0,0.0,38.0,0,24.0,24.0,0,83.0,0,443,0.0,0.0,536,536,551.0,0.0,0.0,19,19,555,998,180.5,180.5,0.0,555,5200.0,75.0,52.0,90,3.0,5.0,4.3,67.0,60.0,20.0,91.0,253,24.0,21.0,17.0,48.0,461,0.0,400.0,400.0,0,401,600.0,15.0,15.0,30.0,60.0,68.0,45.0,128.0,412.0,59.0,-4.0,20.0,24.0,19.0,0.0,0.0,0.0,43.0,0.0,0.0,66.0,4.0,13.5,13.5,9.0,9.0,27.0,18.0,17.0,-14.0,86.0,43,16,16,10,3,0.0,3,30,4,0,-29,59,-4,102,-19,-7,-12,0.0,0.0,0.0,5.0,0.0,69.0,0.0,-19,-83,-83,0.0,0.0,0.0,0.0,0.0,0.0,0.0,-83,0,0.0,0,0,0.0,0.0,30,83,86.0,367,367,367,171,171,196,99,99,27,16.0,0.0,16.0,297,70,-1.0,-1.0,-7.0,1.0,-8.0,0.0,0.0,-4.0,-4.0,70,27,43,43,-126.0,-126.0,43,43,43,180.7,0.24,0.24,0.0,43.0,180.7,0.24,0.24,0.0,0.0,0.0,13.0,0.0,0.0,70,0.0,27.0,43.0,43.0,0.24,0.24,4.0,16,4.0,1.0,1.0,12.0,3.0,126.0,27,70,86,2.0,0.0,0.0,0.0,2.0,4.0,0.0,0.0,0.0,4.0,6.0,0.0,0.0,0.0,6.0,367,196,70,86,43,0,0,998,,555,102,16,19,0,83,,0.24,180.7,,53.41,23.43,19.07,19.07,38.57,11.72,,,,,180.55,,,,,1.0,0.0,,,,,19.74,,,,0.63,1.0,1.19,1.1,0.08,,,,,,,,5900.0,0.7960954446854663,43,367,171,196,70,,30,0,8.800295287608733,,83,79.81981981981981,443,500,0.0,536,998,0.0,0.8972972972972973,498,86.0,23.43,,0.24,,11.72,,53.41,,19.07,19.0,,,,1.19,5900.0,0.06220338983050847,52.0,7.0576923076923075,3.1666666666666665,91.75,0.0,55.611222444889776,0.011864406779661017,0.007288135593220339,99,0,0,-3.0,-155.0,713.0,,70,0.514726507713885,0.26430517711171664,27.02913051811205,25.75,,,,,,,
2007-06,86.0,0,0,0.0,375,379.0,-4.0,378,3.0,35,16,19,79,69.0,214.0,10.0,492,221.0,52.0,8.0,161.0,69,-152.0,89,69.0,21.0,-4.0,91.0,274,242,32,993,62,66,0,45.0,293,244,58.0,49,421,0,0.0,38.0,0,24.0,24.0,0,83.0,0,445,0.0,0.0,528,528,551.0,0.0,0.0,20,20,548,993,180.5,180.5,0.0,548,5300.0,75.0,52.0,89,4.0,5.0,4.3,67.0,60.0,20.0,91.0,244,24.0,21.0,17.0,48.0,457,0.0,400.0,400.0,0,390,600.0,15.0,15.0,30.0,60.0,68.0,45.0,128.0,412.0,59.0,-4.0,20.0,24.0,19.0,0.0,0.0,0.0,43.0,0.0,0.0,66.0,4.0,13.5,13.5,9.0,9.0,27.0,18.0,17.0,-14.0,86.0,92,33,33,29,7,0.0,7,34,1,4,-17,51,-5,195,-46,-15,-31,-5.0,-5.0,0.0,5.0,0.0,69.0,0.0,-51,-144,-144,0.0,0.0,0.0,0.0,0.0,0.0,0.0,-144,0,0.0,0,0,0.0,0.0,34,149,86.0,430,430,430,200,200,230,112,112,30,16.0,0.0,16.0,342,88,-1.0,-1.0,-7.0,1.0,-8.0,0.0,0.0,-4.0,-4.0,88,39,49,49,-126.0,-126.0,49,49,49,180.7,0.27,0.27,0.0,49.0,180.7,0.27,0.27,0.0,0.0,0.0,13.0,0.0,0.0,88,0.0,39.0,49.0,49.0,0.27,0.27,4.0,17,4.0,1.0,1.0,12.0,4.0,126.0,30,88,105,2.0,0.0,0.0,0.0,2.0,4.0,0.0,0.0,0.0,4.0,6.0,0.0,0.0,0.0,6.0,430,230,88,105,49,0,0,993,,548,93,17,27,0,66,,0.27,180.7,,53.49,24.42,20.47,20.47,44.32,11.4,,,,,180.55,,,,,1.0,0.0,,,,,19.35,,,,0.61,1.0,1.17,1.09,0.07,,,,,,,,5900.0,0.9409190371991247,49,430,200,230,88,,34,0,8.912707818654832,,149,81.2043795620438,445,492,0.0,528,993,0.0,0.9142335766423357,501,105.0,24.42,,0.27,,11.4,,53.49,,20.47,27.0,,,,1.17,5900.0,0.07288135593220339,52.0,8.26923076923077,3.225806451612903,430.0,0.0,55.18630412890232,0.014915254237288136,0.008305084745762711,112,0,0,-4.0,-152.0,704.0,,88,0.6107954545454546,0.2744186046511628,27.02913051811205,25.75,,,,,,,
2007-09,86.0,196,196,0.0,394,379.0,-4.0,394,3.0,39,17,22,44,44.0,214.0,10.0,673,221.0,52.0,8.0,161.0,75,-152.0,90,51.0,21.0,-4.0,91.0,186,140,46,1075,75,82,0,45.0,294,236,58.0,58,451,0,0.0,38.0,0,0.0,0.0,84,83.0,1,535,0.0,0.0,2,2,551.0,0.0,0.0,-13,-13,540,1075,180.7,180.7,0.0,540,5300.0,75.0,51.0,90,4.0,5.0,4.3,67.0,60.0,20.0,91.0,236,24.0,21.0,17.0,48.0,634,0.0,400.0,400.0,-196,399,600.0,15.0,15.0,30.0,60.0,68.0,45.0,128.0,412.0,59.0,-4.0,20.0,24.0,19.0,0.0,0.0,0.0,43.0,0.0,0.0,66.0,4.0,13.5,13.5,9.0,9.0,27.0,18.0,17.0,-14.0,86.0,121,51,51,71,11,0.0,11,35,-11,0,13,41,-8,289,-69,-27,-42,-4.0,-4.0,0.0,5.0,0.0,69.0,0.0,-73,-20,-20,0.0,0.0,0.0,0.0,0.0,0.0,0.0,-20,0,196.0,0,196,0.0,0.0,35,220,86.0,439,439,439,210,210,229,128,128,35,16.0,0.0,16.0,373,66,-1.0,-1.0,-7.0,1.0,-8.0,0.0,0.0,-4.0,-4.0,66,37,29,29,-126.0,-126.0,29,29,29,180.5,0.16,0.16,0.0,29.0,180.5,0.16,0.16,0.0,0.0,0.0,13.0,0.0,0.0,66,0.0,37.0,29.0,29.0,0.16,0.16,4.0,18,4.0,1.0,1.0,12.0,4.0,126.0,35,66,84,2.0,0.0,0.0,0.0,2.0,4.0,0.0,0.0,0.0,4.0,6.0,0.0,0.0,0.0,6.0,439,229,66,84,29,196,196,1075,,540,94,18,23,196,71,0.0,0.16,180.45,,52.16,19.13,15.03,15.03,56.06,6.61,5.37,,,,180.7,,,,,1.0,0.0,4712.66,,4516.66,,18.5,,,,0.57,1.0,1.49,1.41,0.21,,,,,,,,5900.0,0.692429022082019,29,439,210,229,66,,35,-196,8.151238734058817,,220,99.07407407407408,535,673,0.0,2,1075,0.0,0.7444444444444445,402,84.0,19.13,,0.16,,6.61,,52.16,,15.03,23.0,,,,1.49,5900.0,0.07440677966101696,51.0,8.607843137254902,2.8,-39.90909090909091,0.0,50.23255813953489,0.011186440677966102,0.004915254237288135,128,196,0,-4.0,-152.0,500.0,,66,0.878,0.23006833712984054,24.38597737613164,26.735,8.73,12.04,,,,,
2007-12,86.0,270,270,0.0,507,379.0,-4.0,507,3.0,51,29,22,45,44.0,214.0,45.0,873,221.0,52.0,8.0,161.0,94,-152.0,90,76.0,21.0,-6.0,91.0,161,140,21,1294,120,88,0,45.0,364,246,58.0,118,572,0,0.0,38.0,0,0.0,0.0,91,88.0,3,663,0.0,0.0,2,2,555.0,79.0,0.0,-5,-5,631,1294,181.0,181.0,0.0,631,5900.0,94.0,61.0,90,6.0,5.0,4.3,67.0,60.0,20.0,91.0,246,24.0,21.0,17.0,48.0,822,0.0,400.0,400.0,-270,465,600.0,15.0,15.0,30.0,60.0,68.0,45.0,128.0,412.0,59.0,-4.0,20.0,24.0,19.0,0.0,0.0,0.0,43.0,0.0,0.0,102.0,15.0,23.0,23.0,16.0,16.0,46.0,32.0,9.0,-14.0,86.0,200,68,68,80,19,0.0,19,20,-128,-12,71,52,37,387,-100,-50,-50,-4.0,-4.0,0.0,5.0,0.0,69.0,0.0,-104,-14,-14,0.0,0.0,0.0,0.0,0.0,0.0,0.0,-14,1,270.0,0,270,0.0,1.0,20,287,86.0,466,466,466,205,205,261,131,131,34,16.0,0.0,16.0,370,96,-1.0,-1.0,-7.0,1.0,-8.0,2.0,2.0,-4.0,-4.0,98,19,79,79,-126.0,-126.0,79,79,79,181.0,0.44,0.44,0.0,79.0,183.0,0.43,0.43,0.0,0.0,0.0,13.0,0.0,0.0,98,0.0,19.0,79.0,79.0,0.44,0.43,4.0,17,4.0,1.0,1.0,12.0,6.0,126.0,34,96,113,2.0,0.0,0.0,0.0,2.0,4.0,0.0,0.0,0.0,4.0,6.0,0.0,0.0,0.0,6.0,466,261,96,113,79,270,270,1294,,631,98,17,31,74,67,0.0,0.43,183.0,,56.01,24.25,20.6,21.03,19.39,16.95,5.78,,,,181.0,,,,,1.0,0.0,4961.21,,4691.21,,18.92,,,,0.62,1.0,1.53,1.44,0.23,,,,,,,,5900.0,0.5669099756690997,79,466,205,261,96,,20,-270,6.6924271990110995,,287,105.0713153724247,663,873,79.0,2,1294,0.0,0.6671949286846276,421,113.0,24.25,,0.43,,16.95,,56.01,,20.6,31.0,,,,1.53,5900.0,0.07898305084745763,61.0,7.639344262295082,1.7083333333333333,-3.640625,4800.0,48.76352395672334,0.016271186440677966,0.013389830508474577,131,270,0,-6.0,-152.0,519.0,,96,0.8978805394990366,0.27896995708154504,23.331058356773504,21.695,7.86,12.09,0.28847457627118644,31.57411047647306,0.054237288135593226,0.03389830508474576,2.901402501758376
2008-03,86.0,339,339,0.0,417,379.0,-4.0,417,3.0,48,25,23,50,44.0,214.0,50.0,854,221.0,52.0,8.0,161.0,93,-152.0,108,83.0,22.0,-6.0,91.0,164,142,22,1302,98,59,0,45.0,397,300,58.0,97,554,0,0.0,38.0,0,0.0,0.0,103,92.0,11,657,0.0,0.0,2,2,525.0,121.0,0.0,-3,-3,645,1302,179.6,179.6,0.0,645,5900.0,93.0,67.0,108,6.0,5.0,4.3,67.0,60.0,20.0,91.0,300,24.0,21.0,17.0,48.0,806,0.0,400.0,400.0,-339,454,600.0,15.0,15.0,30.0,60.0,68.0,45.0,128.0,412.0,59.0,-4.0,20.0,24.0,19.0,0.0,0.0,0.0,43.0,0.0,0.0,102.0,15.0,23.0,23.0,16.0,16.0,46.0,32.0,9.0,-14.0,86.0,42,17,17,6,4,0.0,4,74,102,3,-62,59,-28,143,-20,-4,-16,-22.0,-22.0,0.0,5.0,0.0,69.0,0.0,-42,2,2,-38.0,-38.0,-38.0,0.0,0.0,0.0,0.0,-36,4,69.0,270,339,0.0,1.0,74,123,86.0,375,375,375,181,181,194,116,116,25,16.0,0.0,16.0,322,53,-1.0,-1.0,-7.0,1.0,-8.0,3.0,3.0,-4.0,-4.0,56,14,42,42,-126.0,-126.0,42,42,42,180.4,0.23,0.23,0.0,42.0,182.3,0.23,0.23,0.0,0.0,0.0,13.0,0.0,0.0,56,0.0,14.0,42.0,42.0,0.23,0.23,4.0,17,4.0,1.0,1.0,12.0,5.0,126.0,25,53,70,4.0,1.0,2.0,-1.0,2.0,2.0,0.0,1.0,0.0,1.0,6.0,1.0,3.0,-1.0,3.0,375,194,53,70,42,339,339,1302,,645,143,17,20,69,123,0.0,0.23,182.3,,51.73,18.67,14.13,14.93,25.0,11.2,8.16,33.17,17.3,33.17,179.6,,,,,1.0,0.0,3961.98,,3622.98,1.49,18.01,26.78,1.92,51.33,0.65,1.0,1.54,1.45,0.23,4.32,84.76,10.47,34.94,18.3,20.0,69.81,6400.0,0.4652605459057072,42,375,181,194,53,-0.24285714285714288,74,-339,6.356098866074753,-0.27774027366735465,123,101.86046511627906,657,854,121.0,2,1302,0.0,0.6945736434108527,448,70.0,18.67,-0.18604651162790697,0.23,-0.04166666666666663,11.2,-0.023255813953488413,51.73,0.021798365122615904,14.13,20.0,17.3,33.17,1.49,1.54,6400.0,0.05859375,67.0,5.597014925373134,1.846938775510204,3.676470588235294,1766.6666666666667,49.53917050691244,0.00828125,0.0065625,116,339,0,-6.0,-152.0,464.0,0.5148683092608326,53,0.8081896551724138,0.208,22.725519781697425,22.515,6.14,9.74,0.284864936440678,30.113433094153887,0.050654131355932205,0.033172669491525426,3.194865649216905
2008-06,86.0,367,317,50.0,445,379.0,-4.0,445,3.0,42,20,22,55,44.0,214.0,55.0,909,221.0,52.0,8.0,161.0,94,-152.0,106,74.0,22.0,-6.0,91.0,169,130,39,1352,94,76,0,45.0,392,283,58.0,109,562,0,0.0,38.0,0,0.0,0.0,99,92.0,7,661,0.0,0.0,2,2,537.0,190.0,-34.0,-4,-4,691,1352,178.4,178.4,1.4,691,5900.0,94.0,74.0,106,6.0,5.0,4.3,67.0,60.0,20.0,91.0,283,24.0,21.0,17.0,48.0,867,0.0,400.0,400.0,-367,511,600.0,15.0,15.0,30.0,60.0,68.0,45.0,128.0,412.0,59.0,-4.0,20.0,24.0,19.0,0.0,0.0,0.0,43.0,0.0,0.0,102.0,15.0,23.0,23.0,16.0,16.0,46.0,32.0,9.0,-14.0,86.0,111,33,33,16,9,0.0,9,59,76,9,-38,43,-31,228,-45,-11,-34,-72.0,-22.0,0.0,5.0,0.0,69.0,-50.0,-117,5,5,-72.0,-72.0,-72.0,0.0,0.0,0.0,0.0,-67,3,47.0,270,317,0.0,1.0,59,183,86.0,455,455,455,206,206,249,132,132,25,16.0,0.0,16.0,363,92,-1.0,-1.0,-7.0,1.0,-8.0,2.0,2.0,-4.0,-4.0,94,25,69,69,-126.0,-126.0,69,69,69,179.3,0.38,0.38,0.0,69.0,181.2,0.38,0.38,0.0,0.0,0.0,13.0,0.0,0.0,94,0.0,25.0,69.0,69.0,0.38,0.38,4.0,16,4.0,1.0,1.0,12.0,5.0,126.0,25,92,108,5.0,1.0,2.0,-1.0,3.0,4.0,1.0,2.0,0.0,1.0,9.0,2.0,4.0,-1.0,4.0,455,249,92,108,69,317,367,1352,,691,85,16,25,-22,60,0.0,0.38,181.2,,54.73,23.74,20.22,20.66,26.6,15.16,7.63,36.32,19.19,36.32,178.4,,,,,1.0,0.0,4158.26,,3791.26,1.49,18.54,27.63,1.89,52.3,0.69,1.0,1.62,1.54,0.26,4.25,86.16,10.32,35.46,20.91,17.5,68.2,6400.0,0.52479815455594,69,455,206,249,92,0.045454545454545414,59,-367,3.8783756299179757,-0.5648487857079414,183,95.65846599131693,661,909,190.0,2,1352,0.0,0.6410998552821997,443,108.0,23.74,0.02857142857142847,0.38,0.40740740740740744,15.16,0.40816326530612246,54.73,0.058139534883721034,20.22,25.0,19.19,36.32,1.49,1.62,6400.0,0.07109375,74.0,6.148648648648648,2.1914893617021276,5.9868421052631575,4600.0,51.109467455621306,0.014375,0.01078125,132,367,0,-6.0,-152.0,482.0,0.5177065767284992,92,0.9439834024896265,0.2571428571428571,14.946779477263364,16.11,5.97,9.85,0.28307733050847456,27.992850973571766,0.05011387711864407,0.035648834745762706,3.528053597161077
2008-09,86.0,378,328,50.0,380,379.0,-4.0,380,3.0,42,20,22,58,44.0,214.0,58.0,858,221.0,52.0,8.0,161.0,89,-152.0,106,79.0,22.0,-6.0,91.0,164,129,35,1296,77,80,0,45.0,336,237,58.0,99,493,0,0.0,38.0,0,0.0,0.0,89,83.0,6,582,0.0,0.0,2,2,557.0,250.0,-99.0,4,4,714,1296,176.0,176.0,4.0,714,5900.0,89.0,79.0,106,6.0,5.0,4.3,67.0,60.0,20.0,91.0,237,24.0,21.0,17.0,48.0,816,0.0,400.0,400.0,-378,529,600.0,15.0,15.0,30.0,60.0,68.0,45.0,128.0,412.0,59.0,-4.0,20.0,24.0,19.0,0.0,0.0,0.0,43.0,0.0,0.0,102.0,15.0,23.0,23.0,16.0,16.0,46.0,32.0,9.0,-14.0,86.0,171,47,47,29,17,3.0,14,58,141,9,-60,-3,-29,322,-60,-13,-47,-72.0,-22.0,0.0,5.0,0.0,69.0,-50.0,-132,7,7,-137.0,-137.0,-137.0,0.0,0.0,0.0,0.0,-130,-2,58.0,270,328,0.0,1.0,58,262,86.0,439,439,439,202,202,237,123,123,28,16.0,0.0,16.0,353,86,-1.0,-1.0,-7.0,1.0,-8.0,-1.0,-1.0,-4.0,-4.0,85,25,60,60,-126.0,-126.0,60,60,60,177.5,0.34,0.34,0.0,60.0,179.4,0.33,0.33,0.0,0.0,3.0,13.0,3.0,3.0,88,0.9,25.9,62.1,62.1,0.35,0.35,4.0,14,4.0,1.0,1.0,12.0,5.0,126.0,28,89,103,3.0,1.0,0.0,0.0,2.0,3.0,1.0,1.0,1.0,0.0,6.0,2.0,1.0,1.0,2.0,439,237,86,100,60,328,378,1296,,714,94,14,15,11,79,0.0,0.33,179.4,,53.99,22.78,19.59,19.36,29.41,13.67,9.3,40.83,21.59,40.83,176.0,,,,,1.0,0.0,3480.75,,3102.75,1.47,19.62,28.93,1.89,54.7,0.75,1.0,1.74,1.66,0.28,4.52,81.03,10.49,34.9,19.68,18.6,64.73,6400.0,0.5379901960784313,60,439,202,237,86,0.303030303030303,58,-378,3.7782771394417374,-0.5364781645205983,262,81.5126050420168,582,858,250.0,2,1296,0.0,0.6134453781512605,438,100.0,22.78,0.19047619047619047,0.33,1.0625,13.67,1.0689655172413794,53.99,0.0,19.59,15.0,21.59,40.83,1.47,1.74,6400.0,0.06859375,79.0,5.556962025316456,2.6233766233766236,3.1134751773049647,8600.0,55.092592592592595,0.0134375,0.009375,123,378,0,-6.0,-152.0,494.0,0.6639839034205232,89,0.888663967611336,0.25968109339407747,15.198252831331834,14.585,4.81,7.74,0.2772643008474576,24.94196986163332,0.05236493644067797,0.04010858050847457,3.538717564772413
2008-12,86.0,442,402,40.0,451,379.0,-4.0,451,3.0,44,22,22,78,44.0,214.0,78.0,1015,221.0,52.0,8.0,161.0,88,-152.0,110,94.0,24.0,-10.0,91.0,123,109,14,1430,99,83,0,45.0,358,255,58.0,103,540,0,0.0,38.0,0,0.0,0.0,113,83.0,30,653,0.0,0.0,2,2,572.0,329.0,-137.0,11,11,777,1430,173.6,173.6,6.9,777,5900.0,88.0,80.0,110,10.0,5.0,4.3,67.0,60.0,20.0,91.0,255,24.0,21.0,17.0,48.0,971,0.0,400.0,400.0,-442,573,600.0,15.0,15.0,30.0,60.0,68.0,45.0,128.0,412.0,59.0,-4.0,20.0,24.0,19.0,0.0,0.0,0.0,43.0,0.0,0.0,52.0,16.0,12.0,11.0,9.0,4.0,23.0,13.0,0.0,-14.0,86.0,250,60,60,38,23,3.0,20,69,73,7,-7,13,-17,440,-73,-19,-54,-63.0,-23.0,0.0,5.0,50.0,69.0,-90.0,-136,9,9,-176.0,-176.0,-176.0,0.0,0.0,0.0,0.0,-167,-5,132.0,270,402,1.0,33.0,69,367,86.0,493,493,493,224,224,269,137,137,30,16.0,0.0,16.0,391,102,-1.0,-1.0,-7.0,1.0,-8.0,1.0,1.0,-4.0,-4.0,103,24,79,79,-126.0,-126.0,79,79,79,175.1,0.45,0.45,0.0,79.0,176.1,0.45,0.45,0.0,0.0,0.0,13.0,0.0,0.0,103,0.0,24.0,79.0,79.0,0.45,0.45,4.0,13,4.0,1.0,1.0,12.0,6.0,126.0,30,102,115,-4.0,1.0,3.0,-1.0,-7.0,1.0,1.0,1.0,0.0,-1.0,-3.0,2.0,4.0,-1.0,-8.0,493,269,102,115,79,402,442,1430,,777,118,13,13,74,105,0.0,0.45,176.1,,54.56,23.33,20.69,20.89,23.3,16.02,13.77,35.51,18.36,35.51,173.6,,,,,1.0,0.0,2550.76,,2108.76,1.29,19.18,24.82,1.93,48.01,0.74,1.0,1.88,1.8,0.33,3.68,99.5,7.42,49.3,17.12,21.38,71.59,6400.0,0.5077239958805355,79,493,224,269,102,0.0625,69,-442,4.432238018877032,-0.33772338688541015,367,84.04118404118404,653,1015,329.0,2,1430,0.0,0.5341055341055341,415,115.0,23.33,0.017699115044247815,0.45,0.04651162790697683,16.02,0.0,54.56,0.05793991416309008,20.69,13.0,18.36,35.51,1.29,1.88,6400.0,0.07703125,80.0,6.1625,2.2626262626262625,6.7534246575342465,10200.0,54.33566433566433,0.0159375,0.01234375,137,442,0,-10.0,-152.0,497.0,0.6614173228346457,102,0.9919517102615694,0.26774847870182555,19.66789800495405,16.2,3.31,5.37,0.27531249999999996,23.46512559933824,0.05203125,0.0390625,3.6327887355349455
2009-03,86.0,571,506,65.0,359,379.0,-4.0,359,3.0,52,31,21,67,44.0,214.0,67.0,1049,221.0,52.0,8.0,161.0,91,-152.0,108,84.0,24.0,-10.0,91.0,127,100,27,1459,80,68,0,45.0,389,321,58.0,68,537,0,0.0,38.0,0,0.0,0.0,109,79.0,30,646,0.0,0.0,2,2,580.0,374.0,-158.0,15,15,813,1459,172.6,172.6,8.3,813,5900.0,91.0,84.0,108,10.0,5.0,4.3,67.0,60.0,20.0,91.0,321,24.0,21.0,17.0,48.0,997,0.0,400.0,400.0,-571,621,600.0,15.0,15.0,30.0,60.0,68.0,45.0,128.0,412.0,59.0,-4.0,20.0,24.0,19.0,0.0,0.0,0.0,43.0,0.0,0.0,52.0,16.0,12.0,11.0,9.0,4.0,23.0,13.0,0.0,-14.0,86.0,45,14,14,8,5,3.0,5,93,88,-7,-48,66,-6,165,-20,-9,-11,-21.0,4.0,0.0,5.0,50.0,69.0,-25.0,-41,3,3,-20.0,-20.0,-20.0,0.0,0.0,0.0,0.0,-17,-3,104.0,402,506,1.0,33.0,93,145,86.0,367,367,367,167,167,200,110,110,30,16.0,0.0,16.0,307,60,-1.0,-1.0,-7.0,1.0,-8.0,0.0,0.0,-4.0,-4.0,60,15,45,45,-126.0,-126.0,45,45,45,173.3,0.26,0.26,0.0,45.0,174.3,0.26,0.26,0.0,0.0,0.0,13.0,0.0,0.0,60,0.0,15.0,45.0,45.0,0.26,0.26,4.0,14,4.0,1.0,1.0,12.0,5.0,126.0,30,60,74,4.0,1.0,2.0,-1.0,2.0,2.0,0.0,1.0,0.0,1.0,6.0,1.0,3.0,-1.0,3.0,367,200,60,74,45,506,571,1459,,813,165,14,20,104,145,0.0,0.26,174.3,,54.5,20.16,16.35,16.35,25.0,12.26,13.49,34.71,18.33,34.71,172.6,,,,,1.0,0.0,2815.79,,2244.79,1.27,19.5,24.77,1.89,46.91,0.74,1.0,1.95,1.86,0.35,4.52,80.96,8.98,40.77,15.98,22.9,63.1,6600.0,0.36810431293881646,45,367,167,200,60,0.13207547169811318,93,-571,5.4856615884541045,-0.13694520742377814,145,79.45879458794587,646,1049,374.0,2,1459,0.0,0.5043050430504306,410,74.0,20.16,0.05714285714285716,0.26,0.13043478260869557,12.26,0.0714285714285714,54.5,-0.021333333333333315,16.35,20.0,18.33,34.71,1.27,1.95,6600.0,0.0556060606060606,84.0,4.369047619047619,2.0875,4.170454545454546,0.0,55.72309801233721,0.00909090909090909,0.006818181818181818,110,571,0,-10.0,-152.0,404.0,0.7903225806451613,60,0.9084158415841584,0.2452316076294278,25.73481172194568,23.875,3.44,5.63,0.27232481060606056,22.237158293012723,0.05284090909090909,0.039318181818181815,3.7330149219466904
2009-06,86.0,638,638,0.0,342,379.0,-4.0,342,3.0,45,23,22,73,44.0,214.0,73.0,1098,221.0,52.0,8.0,161.0,91,-152.0,108,93.0,24.0,-10.0,91.0,114,92,22,1504,81,80,0,45.0,378,302,58.0,76,539,0,0.0,38.0,0,0.0,0.0,107,80.0,27,646,0.0,0.0,2,2,592.0,437.0,-188.0,15,15,858,1504,171.7,171.7,9.6,858,5900.0,91.0,93.0,108,10.0,5.0,4.3,67.0,60.0,20.0,91.0,302,24.0,21.0,17.0,48.0,1053,0.0,400.0,400.0,-638,657,600.0,15.0,15.0,30.0,60.0,68.0,45.0,128.0,412.0,59.0,-4.0,20.0,24.0,19.0,0.0,0.0,0.0,43.0,0.0,0.0,52.0,16.0,12.0,11.0,9.0,4.0,23.0,13.0,0.0,-14.0,86.0,107,27,27,16,10,3.0,10,108,105,0,-33,42,-6,268,-40,-13,-27,46.0,6.0,0.0,5.0,65.0,69.0,-25.0,6,9,9,-50.0,-50.0,-50.0,0.0,0.0,0.0,0.0,-41,3,236.0,402,638,1.0,33.0,108,228,86.0,421,421,421,188,188,233,122,122,27,16.0,0.0,16.0,337,84,-1.0,-1.0,-7.0,1.0,-8.0,0.0,0.0,-4.0,-4.0,84,22,62,62,-126.0,-126.0,62,62,62,172.3,0.36,0.36,0.0,62.0,173.9,0.36,0.36,0.0,0.0,0.0,13.0,0.0,0.0,84,0.0,22.0,62.0,62.0,0.36,0.36,4.0,13,4.0,1.0,1.0,12.0,6.0,126.0,27,84,97,3.0,1.0,1.0,0.0,1.0,2.0,1.0,1.0,0.0,0.0,5.0,2.0,2.0,0.0,1.0,421,233,84,97,62,638,638,1504,,858,103,13,20,132,83,0.0,0.36,173.9,,55.34,23.04,19.95,19.95,26.19,14.73,10.0,31.76,17.23,31.76,171.7,,,,,1.0,0.0,4046.36,,3408.36,1.2,19.3,23.25,1.84,42.87,0.74,1.0,2.04,1.95,0.37,4.37,83.73,8.93,41.01,17.95,20.39,63.11,6600.0,0.3998100664767331,62,421,188,233,84,-0.08695652173913049,108,-638,5.937355563850494,0.5308871884531885,228,75.29137529137529,646,1098,437.0,2,1504,0.0,0.4731934731934732,406,97.0,23.04,-0.10185185185185186,0.36,-0.052631578947368474,14.73,-0.10144927536231885,55.34,-0.07472527472527468,19.95,20.0,17.23,31.76,1.2,2.04,6600.0,0.06378787878787878,93.0,4.526881720430108,2.3209876543209877,4.0095238095238095,0.0,57.047872340425535,0.012727272727272728,0.009393939393939394,122,638,0,-10.0,-152.0,382.0,0.7754629629629629,84,1.1020942408376964,0.26365795724465557,29.56616990007965,28.23,4.69,8.78,0.2650189393939394,20.61539136479418,0.05119318181818182,0.037930871212121214,3.89112576029476
2009-09,86.0,704,704,0.0,326,379.0,-4.0,326,3.0,46,27,19,71,44.0,214.0,71.0,1147,221.0,52.0,8.0,161.0,90,-152.0,110,97.0,24.0,-10.0,91.0,95,81,14,1539,81,96,0,45.0,336,265,58.0,71,513,0,0.0,38.0,0,0.0,0.0,111,82.0,29,624,0.0,0.0,2,2,606.0,499.0,-210.0,18,18,915,1539,171.3,171.3,10.5,915,5900.0,90.0,97.0,110,10.0,5.0,4.3,67.0,60.0,20.0,91.0,265,24.0,21.0,17.0,48.0,1101,0.0,400.0,400.0,-704,708,600.0,15.0,15.0,30.0,60.0,68.0,45.0,128.0,412.0,59.0,-4.0,20.0,24.0,19.0,0.0,0.0,0.0,43.0,0.0,0.0,52.0,16.0,12.0,11.0,9.0,4.0,23.0,13.0,0.0,-14.0,86.0,170,46,46,23,20,5.0,15,105,121,-1,-16,7,-6,364,-61,-18,-43,46.0,6.0,0.0,5.0,65.0,69.0,-25.0,-15,16,16,-71.0,-71.0,-71.0,0.0,0.0,0.0,0.0,-55,8,302.0,402,704,1.0,33.0,105,303,86.0,425,425,425,198,198,227,113,113,26,16.0,0.0,16.0,337,88,-1.0,-1.0,-7.0,1.0,-8.0,0.0,0.0,-4.0,-4.0,84,21,63,63,-126.0,-126.0,63,63,63,171.7,0.37,0.37,0.0,63.0,174.1,0.36,0.36,0.0,0.0,5.0,13.0,5.0,5.0,89,1.3,22.3,66.8,66.8,0.39,0.38,4.0,19,4.0,1.0,1.0,12.0,6.0,126.0,26,93,112,1.0,0.0,2.0,-1.0,0.0,1.0,0.0,1.0,0.0,0.0,2.0,0.0,3.0,-1.0,0.0,425,227,88,107,63,704,704,1539,,915,96,19,21,66,75,0.0,0.36,174.1,,53.41,25.18,20.71,19.76,25.0,14.82,8.49,30.57,17.57,30.57,171.3,,,,,1.0,0.0,4727.94,,4023.94,1.2,19.4,23.35,1.74,40.64,0.75,1.0,2.24,2.15,0.41,4.83,75.73,9.84,37.21,17.66,20.73,59.25,6600.0,0.3860127157129882,63,425,198,227,88,0.023255813953488413,105,-704,5.517965502506922,0.4604448797322034,303,68.1967213114754,624,1147,499.0,2,1539,0.0,0.4284153005464481,392,107.0,25.18,0.07000000000000006,0.36,0.09090909090909083,14.82,0.050000000000000044,53.41,-0.03189066059225509,20.71,21.0,17.57,30.57,1.2,2.24,6600.0,0.06439393939393939,97.0,4.381443298969073,2.4444444444444446,3.512396694214876,0.0,59.4541910331384,0.013333333333333334,0.009545454545454546,113,704,0,-10.0,-152.0,373.0,0.7820069204152249,93,1.1394101876675604,0.26823529411764707,29.40558203141429,30.18,5.15,10.19,0.2608191287878787,19.4398726384468,0.05108901515151515,0.03810132575757576,4.1418719803509845
2009-12,86.0,661,661,0.0,387,379.0,-4.0,387,3.0,47,27,20,57,44.0,214.0,57.0,1152,221.0,52.0,8.0,161.0,95,-152.0,109,102.0,24.0,-10.0,91.0,111,84,27,1569,102,109,0,45.0,332,256,58.0,76,543,0,0.0,38.0,0,0.0,0.0,116,83.0,33,659,0.0,0.0,2,2,622.0,583.0,-311.0,14,14,910,1569,168.7,168.7,13.9,910,5900.0,95.0,102.0,109,10.0,5.0,4.3,67.0,60.0,20.0,91.0,256,24.0,21.0,17.0,48.0,1105,0.0,400.0,400.0,-661,699,600.0,15.0,15.0,30.0,60.0,68.0,45.0,128.0,412.0,59.0,-4.0,20.0,24.0,19.0,0.0,0.0,0.0,43.0,0.0,0.0,42.0,15.0,12.0,9.0,4.0,2.0,21.0,6.0,0.0,-14.0,86.0,254,63,63,41,23,5.0,18,74,60,-2,15,-4,5,455,-88,-29,-59,31.0,-9.0,0.0,5.0,65.0,69.0,-25.0,-57,30,30,-174.0,-174.0,-174.0,0.0,0.0,0.0,0.0,-144,5,259.0,402,661,0.0,44.0,74,367,86.0,496,496,496,218,218,278,138,138,34,16.0,0.0,16.0,390,106,-1.0,-1.0,-7.0,1.0,-8.0,0.0,0.0,0.0,0.0,106,22,84,84,-126.0,-126.0,84,84,84,170.2,0.49,0.49,0.0,84.0,173.2,0.48,0.48,0.0,0.0,0.0,13.0,0.0,0.0,106,0.0,22.0,84.0,84.0,0.49,0.48,4.0,17,4.0,1.0,1.0,12.0,6.0,126.0,34,106,123,1.0,1.0,2.0,0.0,-2.0,1.0,1.0,1.0,0.0,-1.0,2.0,2.0,3.0,0.0,-3.0,496,278,106,123,84,661,661,1569,,910,91,17,27,-43,64,0.0,0.48,173.2,,56.05,24.8,21.37,21.37,20.75,16.94,6.72,30.11,16.94,30.11,168.7,,,,,1.0,0.0,5380.82,,4719.82,1.14,19.54,22.27,1.78,39.6,0.76,1.0,2.12,2.03,0.39,4.08,89.73,7.67,47.71,16.95,21.6,63.62,6600.0,0.448868778280543,84,496,218,278,106,0.03921568627450989,74,-661,5.83834214144349,0.317244722999491,367,72.41758241758241,659,1152,583.0,2,1569,0.0,0.4582417582417582,417,123.0,24.8,0.06956521739130439,0.48,0.06666666666666665,16.94,0.06329113924050622,56.05,0.006085192697768749,21.37,27.0,16.94,30.11,1.14,2.12,6600.0,0.07515151515151515,102.0,4.862745098039215,2.1372549019607843,8.266666666666667,0.0,57.998725302740596,0.01606060606060606,0.012727272727272728,138,661,0,-10.0,-152.0,411.0,0.7555066079295154,106,1.2068126520681266,0.28225806451612906,31.21557784203041,29.84,5.83,11.77,0.2589393939393939,18.140117736486012,0.051212121212121216,0.03848484848484848,4.356732922157542
2010-03,86.0,712,712,0.0,334,379.0,-4.0,334,3.0,56,34,22,58,44.0,214.0,58.0,1160,221.0,52.0,8.0,161.0,96,-152.0,109,109.0,24.0,-10.0,91.0,102,75,27,1576,81,77,0,45.0,385,326,58.0,59,543,0,0.0,38.0,0,0.0,0.0,116,81.0,35,659,0.0,0.0,2,2,632.0,650.0,-382.0,15,15,917,1576,166.8,166.8,16.3,917,5900.0,96.0,109.0,109,10.0,5.0,4.3,67.0,60.0,20.0,91.0,326,24.0,21.0,17.0,48.0,1104,0.0,400.0,400.0,-712,699,600.0,15.0,15.0,30.0,60.0,68.0,45.0,128.0,412.0,59.0,-4.0,20.0,24.0,19.0,0.0,0.0,0.0,43.0,0.0,0.0,42.0,15.0,12.0,9.0,4.0,2.0,21.0,6.0,0.0,-14.0,86.0,67,14,14,9,4,5.0,4,44,52,-10,-67,72,-3,138,-21,-6,-15,0.0,0.0,0.0,5.0,65.0,69.0,0.0,-21,6,6,-71.0,-71.0,-71.0,0.0,0.0,0.0,0.0,-65,-1,51.0,661,712,0.0,44.0,44,117,86.0,429,429,429,193,193,236,118,118,32,16.0,0.0,16.0,343,86,-1.0,-1.0,-7.0,1.0,-8.0,0.0,0.0,0.0,0.0,86,19,67,67,-126.0,-126.0,67,67,67,167.8,0.4,0.4,0.0,67.0,170.5,0.39,0.39,0.0,0.0,0.0,13.0,0.0,0.0,86,0.0,19.0,67.0,67.0,0.4,0.39,4.0,14,4.0,1.0,1.0,12.0,5.0,126.0,32,86,100,1.0,1.0,2.0,0.0,-2.0,1.0,1.0,1.0,0.0,-1.0,2.0,2.0,3.0,0.0,-3.0,429,236,86,100,67,712,712,1576,,917,138,14,21,51,117,0.0,0.39,170.5,,55.01,23.31,20.05,20.05,22.09,15.62,6.79,31.91,18.19,31.91,166.8,,,,,1.0,0.0,4816.46,,4104.46,1.17,20.33,23.72,1.75,41.62,0.77,1.0,2.14,2.03,0.39,5.11,71.61,9.9,36.97,14.76,24.8,59.44,7400.0,0.38858695652173914,67,429,193,236,86,0.43333333333333335,44,-712,6.0930172634634845,0.11071694183390868,117,71.8647764449291,659,1160,650.0,2,1576,0.0,0.4536532170119956,416,100.0,23.31,0.3513513513513513,0.39,0.5,15.62,0.48888888888888893,55.01,0.16893732970027253,20.05,21.0,18.19,31.91,1.17,2.14,7400.0,0.05797297297297297,109.0,3.9357798165137616,2.382716049382716,8.25,0.0,58.185279187817265,0.011621621621621621,0.009054054054054054,118,712,0,-10.0,-152.0,367.0,0.9571984435797666,86,1.1689373297002725,0.27505827505827507,33.297358942765285,31.69,5.26,9.61,0.26130630630630625,17.706849933952157,0.05374283374283374,0.04072072072072072,4.617254410273656
2010-06,86.0,724,724,0.0,381,379.0,-4.0,381,3.0,46,24,22,57,44.0,214.0,57.0,1208,221.0,52.0,8.0,161.0,101,-152.0,135,113.0,24.0,-10.0,91.0,105,74,31,1662,82,94,0,45.0,367,307,58.0,60,543,0,0.0,38.0,0,0.0,0.0,113,79.0,34,656,0.0,0.0,2,2,646.0,725.0,-382.0,15,15,1006,1662,167.3,167.3,16.3,1006,5900.0,101.0,113.0,135,10.0,5.0,4.3,67.0,60.0,20.0,91.0,307,24.0,21.0,17.0,48.0,1162,0.0,400.0,400.0,-724,758,600.0,15.0,15.0,30.0,60.0,68.0,45.0,128.0,412.0,59.0,-4.0,20.0,24.0,19.0,0.0,0.0,0.0,43.0,0.0,0.0,42.0,15.0,12.0,9.0,4.0,2.0,21.0,6.0,0.0,-14.0,86.0,141,28,28,11,9,0.0,9,11,5,-1,-43,52,-2,200,-44,-17,-27,-32.0,-32.0,0.0,5.0,0.0,69.0,0.0,-76,14,14,-71.0,-71.0,-71.0,0.0,0.0,0.0,0.0,-57,-4,63.0,661,724,0.0,44.0,11,156,86.0,470,470,470,202,202,268,126,126,36,16.0,0.0,16.0,364,106,-1.0,-1.0,-7.0,1.0,-8.0,0.0,0.0,0.0,0.0,106,32,74,74,-126.0,-126.0,74,74,74,167.0,0.44,0.44,0.0,74.0,169.8,0.44,0.44,0.0,0.0,0.0,13.0,0.0,0.0,106,0.0,32.0,74.0,74.0,0.44,0.44,4.0,14,4.0,1.0,1.0,12.0,6.0,126.0,36,106,120,1.0,1.0,2.0,0.0,-2.0,1.0,1.0,1.0,0.0,-1.0,2.0,2.0,3.0,0.0,-3.0,470,268,106,120,74,724,724,1662,,1006,62,14,23,12,39,0.0,0.44,169.8,,57.02,25.53,22.55,22.55,30.19,15.74,5.63,30.9,18.19,30.9,167.3,,,,,1.0,0.0,5087.11,,4363.11,1.15,20.99,24.13,1.7,40.99,0.75,1.0,2.22,2.14,0.4,5.03,72.7,9.95,36.78,17.82,20.53,56.45,7400.0,0.4044750430292599,74,470,202,268,106,0.26190476190476186,11,-724,6.677322495544444,0.12462904128552266,156,65.20874751491054,656,1208,725.0,2,1662,0.0,0.45129224652087474,454,120.0,25.53,0.23711340206185572,0.44,0.22222222222222232,15.74,0.19354838709677424,57.02,0.11638954869358664,22.55,23.0,18.19,30.9,1.15,2.22,7400.0,0.06351351351351352,113.0,4.15929203539823,2.4634146341463414,94.0,0.0,60.5294825511432,0.014324324324324324,0.01,126,724,0,-10.0,-152.0,444.0,0.9467312348668281,106,1.0585585585585586,0.3021276595744681,40.22387084142341,38.39,5.07,9.7,0.261031941031941,17.33926024892028,0.05533988533988534,0.041326781326781324,4.5737187279945175
2010-09,86.0,741,741,0.0,411,379.0,-4.0,411,3.0,65,41,24,55,44.0,214.0,55.0,1272,221.0,52.0,8.0,161.0,103,-152.0,136,114.0,24.0,-10.0,91.0,130,69,61,1755,88,124,0,45.0,338,265,58.0,73,550,0,0.0,38.0,0,0.0,0.0,121,85.0,36,671,0.0,0.0,2,2,663.0,800.0,-399.0,18,18,1084,1755,167.3,167.3,16.8,1084,5900.0,103.0,114.0,136,10.0,5.0,4.3,67.0,60.0,20.0,91.0,265,24.0,21.0,17.0,48.0,1207,0.0,400.0,400.0,-741,834,600.0,15.0,15.0,30.0,60.0,68.0,45.0,128.0,412.0,59.0,-4.0,20.0,24.0,19.0,0.0,0.0,0.0,43.0,0.0,0.0,42.0,15.0,12.0,9.0,4.0,2.0,21.0,6.0,0.0,-14.0,86.0,216,43,43,16,15,0.0,15,-25,-24,-18,-7,11,13,265,-62,-25,-37,-61.0,-61.0,0.0,5.0,0.0,69.0,0.0,-123,24,24,-88.0,-88.0,-88.0,0.0,0.0,0.0,0.0,-64,2,80.0,661,741,0.0,44.0,-25,203,86.0,489,489,489,210,210,279,133,133,40,16.0,0.0,16.0,383,106,-1.0,-1.0,-7.0,1.0,-8.0,0.0,0.0,0.0,0.0,106,31,75,75,-126.0,-126.0,75,75,75,167.2,0.45,0.45,0.0,75.0,170.1,0.44,0.44,0.0,0.0,0.0,13.0,0.0,0.0,106,0.0,31.0,75.0,75.0,0.45,0.44,4.0,15,4.0,1.0,1.0,12.0,7.0,126.0,40,106,121,1.0,1.0,2.0,0.0,-2.0,1.0,1.0,1.0,0.0,-1.0,2.0,2.0,3.0,0.0,-3.0,489,279,106,121,75,741,741,1755,,1084,65,15,18,17,47,0.0,0.44,170.1,,57.06,24.74,21.68,21.68,29.25,15.34,4.05,30.02,18.21,30.02,167.3,,,,,1.0,0.0,6451.09,,5710.09,1.14,21.44,24.53,1.65,40.42,0.74,1.0,2.31,2.19,0.41,5.11,71.59,9.74,37.58,14.83,24.68,58.69,7400.0,0.40513670256835127,75,489,210,279,106,0.20454545454545459,-25,-741,7.254584749704037,0.31472093227261655,203,61.90036900369004,671,1272,800.0,2,1755,0.0,0.4455719557195572,483,121.0,24.74,0.13084112149532712,0.44,0.22222222222222232,15.34,0.19047619047619047,57.06,0.1505882352941177,21.68,18.0,18.21,30.02,1.14,2.31,7400.0,0.06608108108108109,114.0,4.2894736842105265,2.3863636363636362,-20.375,0.0,61.76638176638176,0.014324324324324324,0.010135135135135136,133,741,0,-10.0,-152.0,505.0,0.9202733485193622,106,0.9683168316831683,0.2985685071574642,47.03331261171756,44.375,5.95,12.31,0.2627190827190827,17.247290634161732,0.05633087633087633,0.041916461916461915,4.402625372010126
2010-12,86.0,883,883,0.0,402,379.0,-4.0,402,3.0,65,39,26,56,44.0,214.0,56.0,1406,221.0,52.0,8.0,161.0,105,-152.0,136,128.0,18.0,-6.0,91.0,108,59,49,1883,102,134,0,45.0,333,263,58.0,70,569,0,0.0,38.0,0,0.0,0.0,125,85.0,40,694,0.0,0.0,2,2,690.0,884.0,-399.0,12,12,1189,1883,168.1,168.1,16.8,1189,5900.0,105.0,116.0,136,6.0,5.0,4.3,67.0,60.0,20.0,91.0,263,24.0,21.0,17.0,48.0,1341,0.0,400.0,400.0,-883,925,600.0,15.0,15.0,30.0,60.0,68.0,45.0,128.0,412.0,59.0,-4.0,20.0,24.0,19.0,0.0,0.0,0.0,43.0,0.0,0.0,54.0,18.0,15.0,9.0,6.0,6.0,24.0,12.0,0.0,-14.0,86.0,301,60,60,41,16,0.0,16,-5,-15,-18,9,10,9,413,-83,-34,-49,-62.0,-62.0,0.0,5.0,0.0,69.0,0.0,-145,41,41,-88.0,-88.0,-88.0,0.0,0.0,0.0,0.0,-47,1,222.0,661,883,0.0,89.0,-5,330,86.0,548,548,548,243,243,305,149,149,39,16.0,0.0,16.0,431,117,-1.0,-1.0,-7.0,1.0,-8.0,0.0,0.0,-1.0,-1.0,116,31,85,85,-126.0,-126.0,85,85,85,167.7,0.51,0.51,0.0,85.0,171.0,0.5,0.5,0.0,0.0,0.0,13.0,0.0,0.0,116,0.0,31.0,85.0,85.0,0.51,0.5,4.0,17,4.0,1.0,1.0,12.0,8.0,126.0,39,117,134,1.0,1.0,2.0,0.0,-2.0,1.0,1.0,1.0,0.0,-1.0,2.0,2.0,3.0,0.0,-3.0,548,305,117,134,85,883,883,1883,0.0,1189,148,17,21,142,127,0.0,0.5,171.0,,55.66,24.45,21.35,21.17,26.72,15.51,4.71,28.68,17.44,28.68,168.1,0.0,0.0,0.0,,1.0,0.0,6894.3,,6011.3,1.12,21.38,23.99,1.64,39.45,0.73,1.0,2.47,2.36,0.44,4.91,74.58,8.31,44.02,15.14,24.17,54.73,7400.0,0.4086502609992543,85,548,243,305,117,0.10377358490566047,-5,-883,7.642738526515497,0.3090597195843481,330,58.36837678721615,694,1406,884.0,2,1883,0.0,0.40117746005046256,477,134.0,24.45,0.08943089430894302,0.5,0.04166666666666674,15.51,0.011904761904761862,55.66,0.10483870967741926,21.35,21.0,17.44,28.68,1.12,2.47,7400.0,0.07405405405405406,116.0,4.724137931034483,2.3823529411764706,-36.53333333333333,0.0,63.143919277748275,0.015810810810810812,0.011486486486486487,149,883,0,-6.0,-152.0,464.0,0.9485714285714286,117,1.1810344827586208,0.2846715328467153,54.1873351701069,50.58,5.82,12.66,0.2616216216216216,17.108683467157,0.05608108108108108,0.04067567567567568,4.37684720270062
2011-03,86.0,778,778,0.0,467,379.0,-4.0,467,3.0,66,38,28,56,44.0,214.0,56.0,1367,221.0,52.0,8.0,161.0,111,-152.0,516,256.0,141.0,-10.0,91.0,109,62,47,2359,98,99,0,45.0,463,400,58.0,63,660,300,300.0,38.0,300,0.0,0.0,125,83.0,42,1085,0.0,0.0,2,2,706.0,949.0,-399.0,16,16,1274,2359,168.7,168.7,16.8,1274,5900.0,111.0,125.0,516,10.0,5.0,4.3,67.0,60.0,20.0,91.0,400,24.0,21.0,17.0,48.0,1301,0.0,400.0,400.0,-478,502,600.0,15.0,15.0,30.0,60.0,68.0,45.0,128.0,412.0,59.0,-4.0,20.0,24.0,19.0,0.0,0.0,0.0,43.0,0.0,0.0,54.0,18.0,15.0,9.0,6.0,6.0,24.0,12.0,0.0,-14.0,86.0,65,18,18,6,6,0.0,6,11,-43,-1,-49,113,-9,106,-27,-8,-19,-499.0,-499.0,0.0,5.0,0.0,69.0,0.0,-526,11,11,0.0,0.0,0.0,300.0,300.0,0.0,300.0,311,4,-105.0,883,778,0.0,89.0,11,79,86.0,506,506,506,231,231,275,150,150,34,16.0,0.0,16.0,415,91,-1.0,-1.0,-7.0,1.0,-8.0,0.0,0.0,-1.0,-1.0,90,25,65,65,-126.0,-126.0,65,65,65,168.4,0.39,0.39,0.0,65.0,171.8,0.38,0.38,0.0,0.0,0.0,13.0,13.0,13.0,103,3.6,28.6,74.4,74.4,0.44,0.43,4.0,17,4.0,1.0,1.0,12.0,9.0,126.0,34,104,125,1.0,1.0,2.0,0.0,-2.0,1.0,1.0,1.0,0.0,-1.0,2.0,2.0,3.0,0.0,-3.0,506,275,91,115,65,778,778,2359,300.0,1274,106,18,27,-105,79,0.0,0.38,171.8,,54.35,22.73,17.98,17.79,27.78,12.85,3.37,27.29,15.2,24.01,168.7,12.72,19.06,23.55,,1.0,0.0,8538.8,,8060.8,1.02,20.77,21.25,1.8,38.16,0.72,1.0,2.07,1.97,0.3,5.03,72.82,9.9,36.97,14.52,25.2,61.05,8600.0,0.3889315910837817,65,506,231,275,91,0.058139534883721034,11,-478,7.004996835698566,0.14967618386767545,79,85.16483516483517,1085,1367,949.0,2,2359,0.0,0.7786499215070644,992,115.0,22.73,0.1499999999999999,0.38,-0.02564102564102566,12.85,-0.02985074626865669,54.35,0.17948717948717952,17.98,27.0,15.2,27.29,1.02,2.07,8600.0,0.05883720930232558,125.0,4.048,2.357142857142857,-11.767441860465116,0.0,54.00593471810089,0.01058139534883721,0.007558139534883721,150,778,300,-10.0,-152.0,958.0,0.6535849056603774,104,0.5281837160751566,0.24703557312252963,52.99504731995233,57.965,6.71,15.3,0.26248585795097423,17.22090365064324,0.055040854808296666,0.039179761156505344,3.7360935890755043
2011-06,86.0,682,682,0.0,416,379.0,-4.0,416,3.0,59,34,25,65,44.0,214.0,65.0,1222,221.0,52.0,8.0,161.0,119,-152.0,714,338.0,222.0,-17.0,91.0,68,58,10,2461,87,128,0,45.0,464,392,58.0,72,679,295,295.0,38.0,295,0.0,0.0,122,85.0,37,1096,0.0,0.0,2,2,730.0,1052.0,-437.0,18,18,1365,2461,168.4,168.4,17.5,1365,5900.0,119.0,133.0,714,17.0,5.0,4.3,67.0,60.0,20.0,91.0,392,24.0,21.0,17.0,48.0,1163,0.0,400.0,400.0,-387,313,600.0,15.0,15.0,30.0,60.0,68.0,45.0,128.0,412.0,59.0,-4.0,20.0,24.0,19.0,0.0,0.0,0.0,43.0,0.0,0.0,54.0,18.0,15.0,9.0,6.0,6.0,24.0,12.0,0.0,-14.0,86.0,168,37,37,11,-20,-28.0,8,89,13,5,-30,95,6,285,-60,-22,-38,-719.0,-719.0,0.0,5.0,0.0,69.0,0.0,-779,25,25,-38.0,-38.0,-38.0,300.0,600.0,-300.0,300.0,287,6,-201.0,883,682,0.0,89.0,89,225,86.0,581,581,581,265,265,316,149,149,41,16.0,0.0,16.0,471,110,-1.0,-1.0,-7.0,1.0,-8.0,0.0,0.0,27.0,27.0,137,34,103,103,-126.0,-126.0,103,103,103,168.7,0.61,0.61,0.0,103.0,172.4,0.6,0.6,0.0,0.0,0.0,13.0,13.0,16.0,153,4.0,38.0,115.0,115.0,0.68,0.67,9.0,19,4.0,1.0,1.0,12.0,8.0,126.0,41,126,154,1.0,1.0,2.0,0.0,-2.0,1.0,1.0,1.0,0.0,-1.0,2.0,2.0,3.0,0.0,-3.0,581,316,126,154,103,682,682,2461,295.0,1365,179,19,33,-96,146,0.0,0.6,172.4,,54.39,26.51,21.69,23.58,24.82,17.73,3.87,27.67,15.91,24.61,168.4,11.99,17.77,21.61,,1.0,0.0,10161.76,,9774.76,1.03,21.14,21.78,1.74,37.87,0.73,1.0,1.8,1.71,0.22,5.33,68.67,11.23,32.59,18.08,20.25,56.33,8600.0,0.4995700773860705,103,581,265,316,110,0.037735849056603765,89,-387,6.67345105142831,-0.0005797898961323877,225,80.29304029304029,1096,1222,1052.0,2,2461,0.0,0.9076923076923077,1239,154.0,26.51,0.28333333333333344,0.6,0.36363636363636354,17.73,0.3918918918918919,54.39,0.2361702127659575,21.69,33.0,15.91,27.67,1.03,1.8,8600.0,0.06755813953488372,133.0,4.368421052631579,3.045977011494253,44.69230769230769,0.0,55.46525802519301,0.012790697674418604,0.01197674418604651,149,682,295,-17.0,-152.0,1147.0,0.5694531741043369,126,0.5065387968613775,0.2874354561101549,53.996803113216615,56.51,7.43,17.15,0.2665304839723444,17.43003266787659,0.05350722815839095,0.04115650534255186,3.184073827378323
2011-09,86.0,691,691,0.0,441,379.0,-4.0,441,3.0,64,40,24,65,44.0,214.0,65.0,1261,221.0,52.0,8.0,161.0,119,-152.0,736,311.0,194.0,-23.0,91.0,59,48,11,2486,96,140,0,45.0,435,353,58.0,82,671,293,293.0,38.0,293,0.0,0.0,121,83.0,38,1085,0.0,0.0,2,2,744.0,1139.0,-494.0,10,10,1401,2486,167.4,167.4,18.7,1401,5900.0,119.0,140.0,736,23.0,5.0,4.3,67.0,60.0,20.0,91.0,353,24.0,21.0,17.0,48.0,1197,0.0,400.0,400.0,-398,354,600.0,15.0,15.0,30.0,60.0,68.0,45.0,128.0,412.0,59.0,-4.0,20.0,24.0,19.0,0.0,0.0,0.0,43.0,0.0,0.0,54.0,18.0,15.0,9.0,6.0,6.0,24.0,12.0,0.0,-14.0,86.0,255,74,74,31,-13,-28.0,15,40,-12,0,0,57,-5,387,-87,-31,-56,-722.0,-722.0,0.0,5.0,0.0,69.0,0.0,-809,29,29,-95.0,-95.0,-95.0,300.0,600.0,-300.0,300.0,234,-4,-192.0,883,691,0.0,89.0,40,300,86.0,602,602,602,274,274,328,156,156,43,7.0,0.0,7.0,480,122,-1.0,-1.0,-7.0,1.0,-8.0,0.0,0.0,-1.0,-1.0,121,34,87,87,-126.0,-126.0,87,87,87,167.9,0.52,0.52,0.0,87.0,171.7,0.51,0.51,0.0,0.0,0.0,13.0,13.0,7.0,128,2.0,36.0,92.0,92.0,0.55,0.54,6.0,19,4.0,1.0,1.0,12.0,8.0,126.0,43,129,154,1.0,1.0,2.0,0.0,-2.0,1.0,1.0,1.0,0.0,-1.0,2.0,2.0,3.0,0.0,-3.0,602,328,129,166,87,691,691,2486,293.0,1401,102,37,27,9,75,0.0,0.51,171.7,,54.49,27.57,21.43,20.1,28.1,14.45,4.65,27.36,16.03,24.48,167.4,11.79,17.3,20.91,,1.0,0.0,9009.1,,8611.1,1.05,20.74,21.88,1.71,37.34,0.73,1.0,1.88,1.78,0.24,5.25,69.7,11.01,33.24,15.71,23.3,59.76,8600.0,0.5029239766081871,87,602,274,328,122,0.15094339622641506,40,-398,7.149459730155846,-0.01449083899012682,300,77.4446823697359,1085,1261,1139.0,2,2486,0.0,0.8743754461099215,1225,166.0,27.57,0.3719008264462811,0.51,0.15909090909090917,14.45,0.15999999999999992,54.49,0.23108384458077702,21.43,27.0,16.03,27.36,1.05,1.88,8600.0,0.07,140.0,4.3,2.8541666666666665,-50.166666666666664,0.0,56.355591311343524,0.014186046511627907,0.010116279069767442,156,691,293,-23.0,-152.0,1178.0,0.5656565656565656,129,0.5110356536502547,0.2857142857142857,59.65689745055593,50.45,6.4,14.14,0.27044940289126335,17.44055898366606,0.053368950345694534,0.04113764927718416,2.7267926493454095
2011-12,86.0,772,772,0.0,494,379.0,-4.0,494,3.0,61,41,20,85,44.0,214.0,85.0,1412,221.0,52.0,8.0,161.0,120,-152.0,742,303.0,194.0,-31.0,91.0,39,28,11,2616,97,192,0,45.0,406,339,58.0,67,695,290,290.0,38.0,290,20.0,20.0,117,77.0,40,1122,0.0,0.0,2,2,765.0,1237.0,-526.0,16,16,1494,2616,167.3,167.3,19.3,1494,5900.0,120.0,140.0,742,31.0,5.0,4.3,67.0,60.0,20.0,91.0,339,24.0,21.0,17.0,48.0,1351,0.0,400.0,400.0,-482,449,600.0,15.0,15.0,30.0,60.0,68.0,45.0,128.0,412.0,59.0,-4.0,20.0,24.0,19.0,0.0,0.0,0.0,43.0,0.0,0.0,54.0,18.0,15.0,9.0,6.0,6.0,24.0,12.0,0.0,-14.0,86.0,353,102,102,71,-7,-28.0,21,-6,-65,3,28,45,-17,513,-110,-42,-68,-722.0,-722.0,0.0,5.0,0.0,69.0,0.0,-832,39,39,-127.0,-127.0,-127.0,300.0,600.0,-300.0,300.0,212,-4,-111.0,883,772,3.0,56.0,-6,403,86.0,673,673,673,299,299,374,179,179,56,6.0,0.0,6.0,540,133,-1.0,-1.0,-7.0,1.0,-8.0,0.0,0.0,0.0,0.0,133,35,98,98,-126.0,-126.0,98,98,98,167.4,0.59,0.59,0.0,98.0,171.3,0.57,0.57,0.0,0.0,0.0,6.0,6.0,12.0,145,3.2,38.2,106.8,106.8,0.64,0.62,5.0,23,4.0,1.0,1.0,12.0,10.0,126.0,56,145,173,1.0,1.0,2.0,0.0,-2.0,1.0,1.0,1.0,0.0,-1.0,2.0,2.0,3.0,0.0,-3.0,673,374,139,218,98,772,772,2616,290.0,1494,126,28,23,81,103,0.0,0.57,171.3,,55.57,32.39,20.65,19.76,26.32,14.56,4.84,26.31,15.69,23.75,167.3,11.09,16.26,19.41,,1.0,0.0,8120.57,,7638.57,1.05,20.36,21.38,1.68,35.86,0.73,1.0,2.03,1.94,0.27,5.27,69.42,10.74,34.07,16.97,21.57,56.92,8600.0,0.4981495188749075,98,673,299,374,133,0.1367521367521367,-6,-482,5.9506578065357045,-0.22139717512372514,403,75.1004016064257,1122,1412,1237.0,2,2616,0.0,0.8058902275769746,1204,218.0,32.39,0.6268656716417911,0.57,0.1399999999999999,14.56,0.15294117647058814,55.57,0.2281021897810218,20.65,23.0,15.69,26.31,1.05,2.03,8600.0,0.07825581395348838,140.0,4.807142857142857,3.082474226804124,-10.353846153846154,0.0,57.11009174311926,0.015465116279069768,0.011395348837209301,179,772,290,-31.0,-152.0,1195.0,0.6075949367088608,145,0.5631799163179916,0.2897473997028232,53.10802128413585,53.005,5.43,11.64,0.2746511627906977,17.523563909774435,0.05302325581395349,0.04104651162790698,2.10893808290478
2012-03,86.0,978,978,0.0,499,379.0,-4.0,499,3.0,54,33,21,83,44.0,214.0,83.0,1614,221.0,52.0,8.0,161.0,122,-152.0,743,301.0,194.0,-38.0,91.0,32,16,16,2812,97,111,0,45.0,537,454,58.0,83,745,286,286.0,38.0,286,20.0,20.0,141,77.0,64,1172,0.0,0.0,2,2,815.0,1328.0,-526.0,21,21,1640,2812,168.7,168.7,19.3,1640,5900.0,122.0,145.0,743,38.0,5.0,4.3,67.0,60.0,20.0,91.0,454,24.0,21.0,17.0,48.0,1560,0.0,400.0,400.0,-692,596,600.0,15.0,15.0,30.0,60.0,68.0,45.0,128.0,412.0,59.0,-4.0,20.0,24.0,19.0,0.0,0.0,0.0,43.0,0.0,0.0,54.0,18.0,15.0,9.0,6.0,6.0,24.0,12.0,0.0,-14.0,86.0,91,30,30,13,-6,-28.0,-6,64,-5,7,-43,116,-11,192,-30,-12,-18,0.0,0.0,0.0,5.0,0.0,69.0,0.0,-30,41,41,-127.0,-127.0,-127.0,0.0,0.0,-300.0,0.0,41,3,206.0,772,978,3.0,56.0,64,162,86.0,613,613,613,275,275,338,165,165,46,6.0,0.0,6.0,486,127,-1.0,-1.0,-7.0,1.0,-8.0,0.0,0.0,-1.0,-1.0,126,35,91,91,-126.0,-126.0,91,91,91,167.9,0.54,0.54,0.0,91.0,171.6,0.53,0.53,0.0,0.0,0.0,2.0,2.0,2.0,128,0.6,35.6,92.4,92.4,0.55,0.54,7.0,23,4.0,1.0,1.0,12.0,11.0,126.0,46,129,159,1.0,1.0,2.0,0.0,-2.0,1.0,1.0,1.0,0.0,-1.0,2.0,2.0,3.0,0.0,-3.0,613,338,127,161,91,978,978,2812,286.0,1640,192,30,30,206,162,0.0,0.53,171.6,,55.14,26.26,20.72,20.55,27.78,14.85,4.15,26.01,14.66,21.66,168.7,10.17,14.85,17.44,,1.0,0.0,11466.92,,10774.92,0.95,20.94,20.0,1.77,35.48,0.73,1.0,2.17,2.09,0.31,5.11,71.6,11.42,32.06,18.55,19.73,59.27,10200.0,0.39294871794871794,91,613,275,338,127,0.39560439560439553,64,-692,7.338993214550892,0.04767973300861872,162,71.46341463414633,1172,1614,1328.0,2,2812,0.0,0.7304878048780488,1198,161.0,26.26,0.3999999999999999,0.53,0.3947368421052633,14.85,0.3999999999999999,55.14,0.21146245059288526,20.72,30.0,14.66,26.01,0.95,2.17,10200.0,0.06009803921568627,145.0,4.227586206896552,2.8350515463917527,-122.6,0.0,58.32147937411095,0.012450980392156863,0.00892156862745098,165,978,286,-38.0,-152.0,1138.0,0.5047709923664122,129,0.538664323374341,0.2822185970636215,71.68522258405874,66.37,7.01,17.13,0.27591199270405836,17.70315011667099,0.05489284085727314,0.042409940720474236,2.1194186902039647
2012-06,76.0,821,821,0.0,505,379.0,-4.0,505,3.0,35,15,20,79,44.0,214.0,79.0,1440,221.0,52.0,8.0,161.0,134,-152.0,925,352.0,246.0,-46.0,91.0,64,33,31,2915,100,121,0,45.0,498,410,58.0,88,719,282,282.0,38.0,282,20.0,20.0,179,76.0,103,1180,0.0,0.0,2,2,844.0,1440.0,-562.0,11,11,1735,2915,168.5,168.5,19.9,1735,5900.0,134.0,152.0,925,46.0,5.0,4.3,67.0,60.0,20.0,91.0,410,24.0,21.0,17.0,48.0,1405,0.0,400.0,400.0,-539,458,600.0,15.0,15.0,30.0,60.0,68.0,45.0,128.0,412.0,59.0,-4.0,20.0,24.0,19.0,0.0,0.0,0.0,43.0,0.0,0.0,54.0,18.0,15.0,9.0,6.0,6.0,24.0,12.0,0.0,-14.0,76.0,203,61,61,22,-3,0.0,-3,61,-1,26,-22,72,-14,344,-69,-31,-38,-238.0,-238.0,0.0,5.0,0.0,69.0,0.0,-307,60,60,-37.0,-37.0,-37.0,-4.0,0.0,-4.0,-4.0,19,-7,49.0,772,821,3.0,56.0,61,275,76.0,665,665,665,283,283,382,179,179,43,6.0,0.0,6.0,505,160,-1.0,-1.0,-7.0,1.0,-8.0,0.0,0.0,0.0,0.0,160,48,112,112,-126.0,-126.0,112,112,112,168.7,0.66,0.66,0.0,112.0,172.3,0.65,0.65,0.0,0.0,0.0,10.0,10.0,10.0,170,3.0,51.0,119.0,119.0,0.71,0.69,8.0,23,4.0,1.0,1.0,12.0,11.0,126.0,43,170,201,1.0,1.0,2.0,0.0,-2.0,1.0,1.0,1.0,0.0,-1.0,2.0,2.0,3.0,0.0,-3.0,665,382,160,191,112,821,821,2915,282.0,1735,152,31,39,-157,113,0.0,0.65,172.3,,57.44,28.72,24.06,24.06,30.0,16.84,3.66,25.03,14.43,21.1,168.5,9.67,13.98,16.25,,1.0,0.0,12148.09,,11609.09,0.95,21.15,20.09,1.73,34.84,0.72,1.0,2.0,1.95,0.25,5.54,66.02,12.1,30.26,24.06,15.21,50.97,10200.0,0.47330960854092524,112,665,283,382,160,0.4545454545454546,61,-539,6.298738471763501,-0.05614974572782838,275,68.01152737752162,1180,1440,1440.0,2,2915,0.0,0.8501440922190202,1475,191.0,28.72,0.24025974025974017,0.65,0.08333333333333348,16.84,0.08737864077669899,57.44,0.14457831325301207,24.06,39.0,14.43,25.03,0.95,2.0,10200.0,0.06519607843137255,152.0,4.375,2.83,-665.0,0.0,59.51972555746141,0.01568627450980392,0.010980392156862745,179,821,282,-46.0,-152.0,1394.0,0.4510035419126328,170,0.4770444763271162,0.30526315789473685,64.77955689691568,73.9,6.99,17.46,0.2735499316005472,17.709729064039408,0.05778841769265846,0.04141358869129047,2.0899243696697036
2012-09,67.0,909,909,0.0,524,379.0,-4.0,524,3.0,41,19,22,79,44.0,214.0,79.0,1553,221.0,52.0,8.0,161.0,143,-152.0,933,355.0,249.0,-56.0,91.0,67,34,33,3051,107,136,0,45.0,451,352,58.0,99,694,278,278.0,38.0,278,69.0,69.0,132,80.0,52,1173,0.0,0.0,2,2,875.0,1544.0,-565.0,22,22,1878,3051,169.1,169.1,19.9,1878,5900.0,143.0,162.0,933,56.0,5.0,4.3,67.0,60.0,20.0,91.0,352,24.0,21.0,17.0,48.0,1512,0.0,400.0,400.0,-631,590,600.0,15.0,15.0,30.0,60.0,68.0,45.0,128.0,412.0,59.0,-4.0,20.0,24.0,19.0,0.0,0.0,0.0,43.0,0.0,0.0,54.0,18.0,15.0,9.0,6.0,6.0,24.0,12.0,0.0,-14.0,67.0,307,93,93,28,-2,0.0,-2,25,-20,21,23,19,-18,451,-109,-49,-60,-239.0,-239.0,0.0,5.0,0.0,69.0,0.0,-348,81,81,-39.0,-39.0,-39.0,-8.0,0.0,-8.0,-8.0,34,0,137.0,772,909,3.0,56.0,25,342,67.0,647,647,647,286,286,361,174,174,44,6.0,0.0,6.0,504,143,-1.0,-1.0,-7.0,1.0,-8.0,0.0,0.0,0.0,0.0,143,39,104,104,-126.0,-126.0,104,104,104,168.8,0.62,0.62,0.0,104.0,172.4,0.6,0.6,0.0,0.0,0.0,2.0,2.0,2.0,145,0.5,39.5,105.5,105.5,0.62,0.61,11.0,21,4.0,1.0,1.0,12.0,9.0,126.0,44,145,177,1.0,1.0,2.0,0.0,-2.0,1.0,1.0,1.0,0.0,-1.0,2.0,2.0,3.0,0.0,-3.0,647,361,143,175,104,909,909,3051,278.0,1878,107,32,40,88,67,0.0,0.6,172.4,,55.8,27.05,22.1,22.1,27.27,16.07,3.43,24.7,14.63,21.04,169.1,9.11,12.89,14.8,,1.0,0.0,12714.13,,12083.13,0.94,21.63,20.3,1.69,34.28,0.72,1.0,2.24,2.18,0.28,5.38,67.97,11.26,32.5,21.77,16.81,52.28,10200.0,0.4279100529100529,104,647,286,361,143,0.1721311475409837,25,-631,5.549561549553867,-0.22377889252998195,342,62.460063897763575,1173,1553,1544.0,2,3051,0.0,0.7976570820021299,1498,175.0,27.05,0.054216867469879526,0.6,0.17647058823529416,16.07,0.1954022988505748,55.8,0.07475083056478415,22.1,40.0,14.63,24.7,0.94,2.24,10200.0,0.06343137254901961,162.0,3.993827160493827,2.6728971962616823,-32.35,0.0,61.5535889872173,0.014019607843137254,0.01019607843137255,174,909,278,-56.0,-152.0,1455.0,0.44739840486137483,145,0.4446735395189003,0.2890262751159196,61.74215989373319,65.61,6.79,17.49,0.2669813041495668,17.403556224533236,0.05762197902416781,0.041493388052895576,2.0235622555383492
2012-12,81.0,729,729,0.0,668,379.0,-4.0,668,3.0,47,26,21,90,44.0,214.0,90.0,1534,221.0,52.0,8.0,161.0,150,-152.0,932,359.0,251.0,-65.0,91.0,91,29,62,3066,141,186,0,45.0,479,375,58.0,104,806,274,274.0,38.0,274,83.0,83.0,124,73.0,51,1287,0.0,0.0,2,2,898.0,1656.0,-806.0,29,29,1779,3066,165.7,165.7,23.8,1779,5900.0,150.0,173.0,932,65.0,5.0,4.3,67.0,60.0,20.0,91.0,375,30.0,21.0,17.0,48.0,1487,0.0,400.0,400.0,-455,488,600.0,15.0,15.0,30.0,60.0,68.0,45.0,128.0,412.0,59.0,-4.0,20.0,24.0,19.0,0.0,0.0,0.0,43.0,0.0,0.0,54.0,18.0,15.0,9.0,6.0,6.0,24.0,12.0,0.0,-14.0,81.0,419,126,126,77,6,0.0,6,-53,-165,14,105,42,-49,575,-148,-67,-81,-274.0,-274.0,0.0,5.0,0.0,69.0,0.0,-422,92,92,-277.0,-277.0,-277.0,-11.0,0.0,-11.0,-11.0,-196,0,-43.0,772,729,4.0,54.0,-53,427,81.0,740,740,740,330,330,410,210,210,50,6.0,0.0,6.0,590,150,-1.0,-1.0,-7.0,1.0,-8.0,0.0,0.0,-1.0,-1.0,149,37,112,112,-126.0,-126.0,112,112,112,167.4,0.67,0.67,0.0,112.0,170.5,0.66,0.66,0.0,0.0,0.0,7.0,7.0,7.0,156,1.7,38.7,117.3,117.3,0.7,0.69,59.0,33,4.0,1.0,1.0,12.0,12.0,126.0,50,157,249,1.0,1.0,2.0,0.0,-2.0,1.0,1.0,1.0,0.0,-1.0,2.0,2.0,3.0,0.0,-3.0,740,410,150,242,112,729,729,3066,274.0,1779,124,33,39,-180,85,0.0,0.66,170.5,,55.41,32.7,20.27,20.14,24.83,15.14,4.02,25.6,14.75,21.84,165.7,8.94,13.35,15.4,,1.0,0.0,10465.6,,10010.6,0.94,21.69,20.34,1.74,35.32,0.72,1.0,1.9,1.84,0.24,4.59,79.79,9.87,37.1,21.74,16.83,59.53,10200.0,0.4976462676529926,112,740,330,410,150,0.1278195488721805,-53,-455,4.997348377158146,-0.1602023608768972,427,72.34401349072512,1287,1534,1656.0,2,3066,0.0,0.8611579539066891,1532,242.0,32.7,0.11009174311926606,0.66,0.1578947368421053,15.14,0.1428571428571428,55.41,0.09955423476968805,20.27,39.0,14.75,25.6,0.94,1.9,10200.0,0.07254901960784314,173.0,4.277456647398844,2.3404255319148937,-4.484848484848484,0.0,58.023483365949126,0.014705882352941176,0.010980392156862745,210,729,274,-65.0,-152.0,1541.0,0.43932748538011696,157,0.48020765736534715,0.2702702702702703,53.10802128413585,53.005,5.76,14.18,0.26127450980392153,16.873870014789222,0.056862745098039215,0.04107843137254902,1.9405899965857047
2013-03,67.0,853,853,0.0,510,379.0,-4.0,510,3.0,65,44,21,81,44.0,214.0,81.0,1509,221.0,52.0,8.0,161.0,148,-152.0,921,352.0,251.0,-65.0,91.0,87,25,62,3017,111,115,0,45.0,557,457,58.0,100,783,271,271.0,38.0,271,85.0,85.0,125,71.0,54,1264,0.0,0.0,2,2,920.0,1715.0,-901.0,17,17,1753,3017,164.5,164.5,25.4,1753,5900.0,148.0,352.0,921,65.0,5.0,4.3,67.0,60.0,20.0,91.0,457,32.0,21.0,17.0,48.0,1444,0.0,400.0,400.0,-582,480,600.0,15.0,15.0,30.0,60.0,68.0,45.0,128.0,412.0,59.0,-4.0,20.0,24.0,19.0,0.0,0.0,0.0,43.0,0.0,0.0,54.0,18.0,15.0,9.0,6.0,6.0,24.0,12.0,0.0,-14.0,67.0,59,34,34,6,10,0.0,10,134,158,-18,-87,84,-3,243,-27,-10,-17,-274.0,-274.0,0.0,5.0,0.0,69.0,0.0,-27,10,10,-93.0,-93.0,-93.0,-4.0,0.0,-4.0,-4.0,-87,-5,124.0,729,853,4.0,54.0,134,216,67.0,587,587,587,282,282,305,179,179,50,6.0,0.0,6.0,511,76,-1.0,-1.0,-7.0,1.0,-8.0,0.0,0.0,-1.0,-1.0,75,16,59,59,-126.0,-126.0,59,59,59,165.4,0.36,0.36,0.0,59.0,168.5,0.35,0.35,0.0,0.0,0.0,7.0,7.0,7.0,75,1.7,16.0,59.0,59.0,0.36,0.35,11.0,23,4.0,1.0,1.0,12.0,13.0,126.0,50,76,110,1.0,1.0,2.0,0.0,-2.0,1.0,1.0,1.0,0.0,-1.0,2.0,2.0,3.0,0.0,-3.0,587,305,76,110,59,853,853,3017,271.0,1753,243,34,27,124,216,0.0,0.35,168.5,,51.96,18.74,12.95,12.78,21.33,10.05,4.81,22.81,13.28,19.59,164.5,8.98,13.39,15.46,,1.0,0.0,9657.63,,9075.63,0.91,19.97,18.08,1.72,31.06,0.73,1.0,1.93,1.84,0.24,5.23,69.97,11.36,32.23,19.85,18.44,56.18,10800.0,0.40650969529085873,59,587,282,305,76,-0.40157480314960625,134,-582,5.5533857576667085,-0.24330414331817218,216,72.10496292070737,1264,1509,1715.0,2,3017,0.0,0.8602395892755277,1508,110.0,18.74,-0.31677018633540377,0.35,-0.339622641509434,10.05,-0.3516483516483516,51.96,-0.04241435562805873,12.95,27.0,13.28,22.81,0.91,1.93,10800.0,0.05435185185185185,352.0,1.6676136363636365,2.5405405405405403,3.7151898734177213,0.0,58.104076897580384,0.007037037037037037,0.005462962962962963,179,853,271,-65.0,-152.0,1388.0,0.4338875692794933,76,0.4229106628242075,0.21465076660988075,58.85783091408548,57.34,5.49,13.86,0.2555283224400871,14.313897444256307,0.05144880174291939,0.037619825708061,1.8248363360355713
2013-06,80.0,826,826,0.0,514,379.0,-4.0,514,3.0,70,49,21,83,44.0,214.0,83.0,1493,221.0,52.0,8.0,161.0,156,-152.0,934,350.0,253.0,-85.0,91.0,109,24,85,3042,105,116,0,45.0,553,422,58.0,131,774,263,263.0,38.0,263,86.0,86.0,129,72.0,57,1252,0.0,0.0,2,2,941.0,1823.0,-988.0,12,12,1790,3042,163.1,163.1,27.1,1790,5900.0,156.0,182.0,934,85.0,5.0,4.3,67.0,60.0,20.0,91.0,422,29.0,21.0,17.0,48.0,1423,0.0,400.0,400.0,-563,506,600.0,15.0,15.0,30.0,60.0,68.0,45.0,128.0,412.0,59.0,-4.0,20.0,24.0,19.0,0.0,0.0,0.0,43.0,0.0,0.0,54.0,18.0,15.0,9.0,6.0,6.0,24.0,12.0,0.0,-14.0,80.0,167,70,70,6,23,0.0,23,117,157,-23,-72,46,9,383,-65,-31,-34,-39.0,-39.0,0.0,5.0,0.0,69.0,0.0,-104,19,19,-184.0,-184.0,-184.0,-8.0,0.0,-8.0,-8.0,-173,-9,97.0,729,826,4.0,54.0,117,318,80.0,670,670,670,291,291,379,185,185,47,6.0,0.0,6.0,523,147,-1.0,-1.0,-7.0,1.0,-8.0,0.0,0.0,0.0,0.0,147,39,108,108,-126.0,-126.0,108,108,108,163.4,0.66,0.66,0.1,108.1,166.3,0.65,0.65,0.0,0.0,0.0,7.0,7.0,7.0,147,1.7,39.0,108.0,108.0,0.66,0.65,11.0,25,4.0,1.0,1.0,12.0,14.0,126.0,47,147,183,1.0,1.0,2.0,0.0,-2.0,1.0,1.0,1.0,0.0,-1.0,2.0,2.0,3.0,0.0,-3.0,670,379,147,183,108,826,826,3042,263.0,1790,140,36,38,-27,102,0.0,0.65,166.3,,56.57,27.31,21.94,21.94,26.53,16.12,5.52,21.73,12.86,18.82,163.1,8.65,12.81,14.69,,1.0,0.0,8207.58,,7644.58,0.89,19.44,17.26,1.69,29.16,0.75,1.0,1.93,1.84,0.24,5.19,70.53,11.6,31.55,22.65,16.16,55.14,10800.0,0.4708362614195362,108,670,291,379,147,-0.08125000000000004,117,-563,4.047193984608775,-0.3574595924641313,318,69.9441340782123,1252,1493,1823.0,2,3042,0.0,0.8653631284916201,1549,183.0,27.31,-0.041884816753926746,0.65,0.0,16.12,-0.0357142857142857,56.57,0.007518796992481258,21.94,38.0,12.86,21.73,0.89,1.93,10800.0,0.062037037037037036,182.0,3.681318681318681,2.7714285714285714,4.267515923566879,0.0,58.84286653517423,0.01361111111111111,0.01,185,826,263,-85.0,-152.0,1464.0,0.36738978306508047,147,0.4576502732240437,0.28955223880597014,44.3358459758244,45.89,4.58,11.96,0.2523692810457516,13.620216125574988,0.049373638344226575,0.03663943355119825,1.8054421329324988
2013-09,81.0,862,862,0.0,546,379.0,-4.0,546,3.0,67,44,23,85,44.0,214.0,85.0,1560,221.0,52.0,8.0,161.0,157,-152.0,945,348.0,255.0,-96.0,91.0,108,25,83,3118,98,124,0,45.0,500,374,58.0,126,722,255,255.0,38.0,255,87.0,87.0,136,81.0,55,1200,0.0,0.0,2,2,963.0,1921.0,-989.0,21,21,1918,3118,163.4,163.4,27.1,1918,5900.0,157.0,189.0,945,96.0,5.0,4.3,67.0,60.0,20.0,91.0,374,26.0,21.0,17.0,48.0,1493,0.0,400.0,400.0,-607,625,600.0,15.0,15.0,30.0,60.0,68.0,45.0,128.0,412.0,59.0,-4.0,20.0,24.0,19.0,0.0,0.0,0.0,43.0,0.0,0.0,54.0,18.0,15.0,9.0,6.0,6.0,24.0,12.0,0.0,-14.0,81.0,265,109,109,7,32,0.0,32,34,126,-19,-86,-5,18,447,-100,-44,-56,-39.0,-39.0,0.0,5.0,0.0,69.0,0.0,-139,30,30,-187.0,-187.0,-187.0,-11.0,0.0,-11.0,-11.0,-168,-7,133.0,729,862,4.0,54.0,34,347,81.0,666,666,666,308,308,358,183,183,43,6.0,0.0,6.0,534,132,-1.0,-1.0,-7.0,1.0,-8.0,0.0,0.0,0.0,0.0,132,34,98,98,-126.0,-126.0,98,98,98,163.2,0.6,0.6,0.1,98.0,166.4,0.59,0.59,0.0,0.0,0.0,7.0,7.0,7.0,132,1.7,34.0,98.0,98.0,0.6,0.59,11.0,28,4.0,1.0,1.0,12.0,12.0,126.0,43,132,171,1.0,1.0,2.0,0.0,-2.0,1.0,1.0,1.0,0.0,-1.0,2.0,2.0,3.0,0.0,-3.0,666,358,132,171,98,862,862,3118,255.0,1918,64,39,35,36,29,0.0,0.59,166.4,,53.75,25.68,19.82,19.82,25.76,14.71,4.64,19.86,12.22,17.42,163.4,8.18,11.73,13.3,,1.0,0.0,9042.26,,8435.26,0.86,18.89,16.31,1.63,26.5,0.75,1.0,2.16,2.07,0.27,4.98,73.53,11.81,30.98,22.43,16.32,58.87,10800.0,0.44608171466845276,98,666,308,358,132,-0.07692307692307687,34,-607,3.7938427841898936,-0.31637071680106277,347,62.56517205422315,1200,1560,1921.0,2,3118,0.0,0.8123044838373306,1558,171.0,25.68,-0.02285714285714291,0.59,-0.01666666666666672,14.71,-0.05769230769230771,53.75,0.029366306027820643,19.82,35.0,12.22,19.86,0.86,2.16,10800.0,0.06166666666666667,189.0,3.5238095238095237,3.142857142857143,5.285714285714286,0.0,61.513790891597175,0.012222222222222223,0.009074074074074075,183,862,255,-96.0,-152.0,1559.0,0.33974784339747843,132,0.42719692110327134,0.2627627627627628,44.58695134850623,42.18,4.72,13.52,0.2506045751633987,13.150198488890684,0.04757625272331154,0.03551742919389979,1.7879655145168698
2013-12,70.0,695,695,0.0,717,379.0,-4.0,717,3.0,56,39,17,95,44.0,214.0,95.0,1563,221.0,52.0,8.0,161.0,161,-152.0,946,344.0,251.0,-102.0,91.0,82,24,58,3096,114,136,0,45.0,526,390,58.0,136,776,248,248.0,38.0,248,87.0,87.0,128,76.0,52,1239,0.0,0.0,2,2,973.0,2033.0,-1184.0,33,33,1857,3096,159.3,159.3,31.6,1857,5900.0,161.0,195.0,946,102.0,5.0,4.3,67.0,60.0,20.0,91.0,390,25.0,21.0,17.0,48.0,1507,0.0,400.0,400.0,-447,567,600.0,15.0,15.0,30.0,60.0,68.0,45.0,128.0,412.0,59.0,-4.0,20.0,24.0,19.0,0.0,0.0,0.0,43.0,0.0,0.0,73.0,22.0,20.0,13.0,10.0,8.0,33.0,18.0,0.0,-14.0,70.0,377,147,147,18,67,25.0,42,-99,-46,-9,-63,9,10,510,-138,-60,-78,-36.0,-36.0,0.0,5.0,0.0,69.0,0.0,-174,35,35,-382.0,-382.0,-382.0,-15.0,0.0,-15.0,-15.0,-362,-8,-34.0,729,695,4.0,124.0,-99,372,70.0,769,769,769,338,338,431,210,210,44,6.0,0.0,6.0,592,177,-1.0,-1.0,-7.0,1.0,-8.0,0.0,0.0,-23.0,-23.0,154,42,112,112,-126.0,-126.0,112,112,112,161.6,0.69,0.69,0.1,112.0,164.3,0.68,0.68,0.0,0.0,0.0,7.0,7.0,7.0,154,1.7,42.0,112.0,112.0,0.69,0.68,11.0,27,4.0,1.0,1.0,12.0,10.0,126.0,44,177,215,1.0,1.0,2.0,0.0,-2.0,1.0,1.0,1.0,0.0,-1.0,2.0,2.0,3.0,0.0,-3.0,769,431,177,215,112,695,695,3096,248.0,1857,63,38,38,-167,25,0.0,0.68,164.3,,56.05,27.96,23.02,20.03,27.27,14.56,4.92,20.74,12.24,18.13,159.3,8.01,11.78,13.35,,1.0,0.0,7433.07,,6986.07,0.87,18.87,16.49,1.69,27.94,0.74,1.0,2.01,1.94,0.25,3.89,94.15,9.56,38.28,23.67,15.46,71.33,10800.0,0.5102853351028533,112,769,338,431,177,0.17999999999999994,-99,-447,3.7127714702385046,-0.2570517022169555,372,66.72051696284329,1239,1563,2033.0,2,3096,0.0,0.8255250403877221,1533,215.0,27.96,-0.11157024793388426,0.68,0.030303030303030276,14.56,0.0,56.05,0.03918918918918912,23.02,38.0,12.24,20.74,0.87,2.01,10800.0,0.0712037037037037,195.0,3.943589743589744,2.9649122807017543,-16.717391304347824,0.0,59.98062015503876,0.01638888888888889,0.01037037037037037,210,695,248,-102.0,-152.0,1664.0,0.33198127925117005,177,0.4621394230769231,0.28738621586475943,42.66470680837193,46.31,3.9,10.29,0.24925925925925924,12.816331585081585,0.04925925925925926,0.03490740740740741,1.7698972802284456
2014-03,91.0,922,922,0.0,607,379.0,-4.0,607,3.0,42,25,17,88,44.0,214.0,88.0,1659,221.0,52.0,8.0,161.0,159,-152.0,946,337.0,244.0,-106.0,91.0,77,24,53,3178,97,133,0,45.0,652,499,58.0,153,882,240,240.0,38.0,240,78.0,78.0,129,75.0,54,1329,0.0,0.0,2,2,993.0,2092.0,-1270.0,32,32,1849,3178,157.7,157.7,33.6,1849,5900.0,159.0,199.0,946,106.0,5.0,4.3,67.0,60.0,20.0,91.0,499,24.0,21.0,17.0,48.0,1617,0.0,400.0,400.0,-682,566,600.0,15.0,15.0,30.0,60.0,68.0,45.0,128.0,412.0,59.0,-4.0,20.0,24.0,19.0,0.0,0.0,0.0,43.0,0.0,0.0,73.0,22.0,20.0,13.0,10.0,8.0,33.0,18.0,0.0,-14.0,91.0,59,41,41,-5,19,8.0,11,229,111,14,3,109,-8,343,-33,-12,-21,-4.0,-4.0,0.0,5.0,0.0,69.0,0.0,-37,8,8,-86.0,-86.0,-86.0,-4.0,0.0,-4.0,-4.0,-82,3,227.0,695,922,4.0,124.0,229,310,91.0,628,628,628,295,295,333,188,188,56,6.0,0.0,6.0,539,89,-1.0,-1.0,-7.0,1.0,-8.0,0.0,-8.0,1.0,1.0,82,23,59,59,-126.0,-126.0,59,59,59,158.4,0.37,0.37,0.5,59.5,160.9,0.37,0.37,0.0,0.0,0.0,7.0,7.0,7.0,82,1.7,23.0,59.0,59.0,0.37,0.37,11.0,30,4.0,1.0,1.0,12.0,12.0,126.0,56,89,130,1.0,1.0,2.0,0.0,-2.0,1.0,1.0,1.0,0.0,-1.0,2.0,2.0,3.0,0.0,-3.0,628,333,89,130,59,922,922,3178,240.0,1849,343,41,33,227,310,0.0,0.37,160.9,,53.03,20.7,14.17,13.06,28.05,9.39,5.76,20.93,12.17,18.37,157.7,7.55,11.49,12.98,89.0,1.0,0.0,7848.25,,7166.25,0.88,18.84,16.63,1.72,28.6,0.73,1.0,1.88,1.83,0.24,4.89,74.79,11.85,30.9,23.03,15.89,59.79,11500.0,0.3883735312306741,59,628,295,333,89,0.17105263157894735,229,-682,3.662473013810265,-0.3404972797443344,310,71.87669010275825,1329,1659,2092.0,2,3178,0.0,0.8215251487290427,1519,130.0,20.7,0.18181818181818188,0.37,0.05714285714285716,9.39,0.0,53.03,0.06984667802385003,14.17,33.0,12.17,20.93,0.88,1.88,11500.0,0.05460869565217391,199.0,3.1557788944723617,3.0412371134020617,5.657657657657658,1112.5,58.181246066708624,0.007739130434782609,0.005130434782608695,188,922,240,-106.0,-152.0,1425.0,0.3874866690366157,89,0.44070175438596493,0.23089171974522293,42.7519735008534,41.915,4.2,10.25,0.2495161030595813,14.30449684319031,0.04996135265700483,0.03457487922705314,1.787688371790203
2014-06,97.0,934,934,0.0,550,379.0,-4.0,550,3.0,50,33,17,103,44.0,214.0,103.0,1637,221.0,52.0,8.0,161.0,156,-152.0,950,322.0,245.0,-119.0,91.0,71,24,47,3136,112,125,0,45.0,609,442,58.0,167,846,225,225.0,38.0,225,73.0,73.0,130,72.0,58,1274,0.0,0.0,2,2,1012.0,2188.0,-1374.0,34,34,1862,3136,155.4,155.4,36.1,1862,5900.0,156.0,196.0,950,119.0,5.0,4.3,67.0,60.0,20.0,91.0,442,26.0,21.0,17.0,48.0,1587,0.0,400.0,400.0,-709,590,600.0,15.0,15.0,30.0,60.0,68.0,45.0,128.0,412.0,59.0,-4.0,20.0,24.0,19.0,0.0,0.0,0.0,43.0,0.0,0.0,73.0,22.0,20.0,13.0,10.0,8.0,33.0,18.0,0.0,-14.0,97.0,155,84,84,-12,33,9.0,24,221,168,6,2,53,-8,481,-58,-21,-37,-7.0,-7.0,0.0,5.0,0.0,69.0,0.0,-65,15,15,-184.0,-184.0,-184.0,-11.0,0.0,-11.0,-11.0,-180,3,239.0,695,934,4.0,124.0,221,423,97.0,676,676,676,305,305,371,188,188,50,0.0,0.0,6.0,543,133,-1.0,-1.0,0.0,1.0,-1.0,0.0,-1.0,0.0,0.0,132,36,96,96,-126.0,-126.0,96,96,96,156.9,0.61,0.61,0.5,96.0,159.4,0.6,0.6,0.0,0.0,0.0,7.0,7.0,0.0,132,0.0,36.0,96.0,96.0,0.61,0.6,12.0,31,4.0,1.0,1.0,12.0,13.0,126.0,50,133,176,1.0,1.0,2.0,0.0,-2.0,1.0,1.0,1.0,0.0,-1.0,2.0,2.0,3.0,0.0,-3.0,676,371,133,176,96,934,934,3136,225.0,1862,138,43,25,12,113,0.0,0.6,159.4,,54.88,26.04,19.67,19.53,27.27,14.2,7.29,19.99,11.82,17.7,155.4,7.17,10.78,12.08,133.0,1.0,0.0,6339.54,,5630.54,0.89,18.25,16.19,1.69,27.38,0.73,1.0,1.93,1.88,0.25,5.15,71.09,11.48,31.87,20.77,17.62,56.84,11500.0,0.42596093257718964,96,676,305,371,133,-0.09523809523809523,221,-709,3.58964393677255,-0.11305364891731384,423,68.42105263157895,1274,1637,2188.0,2,3136,0.0,0.8050483351235231,1499,176.0,26.04,-0.03825136612021862,0.6,-0.07692307692307698,14.2,-0.11111111111111116,54.88,0.008955223880596996,19.67,25.0,11.82,19.99,0.89,1.93,11500.0,0.058782608695652175,196.0,3.4489795918367347,2.7232142857142856,4.023809523809524,13300.0,59.375,0.011565217391304347,0.008347826086956521,188,934,225,-119.0,-152.0,1424.0,0.36772853185595566,133,0.4747191011235955,0.27071005917159763,42.59985347527398,41.29,3.36,8.14,0.24626167471819643,14.072157753708364,0.04791545893719807,0.03292270531400966,1.804757199689755
2014-09,89.0,848,848,0.0,522,379.0,-4.0,522,3.0,44,27,17,92,44.0,214.0,92.0,1506,221.0,52.0,8.0,161.0,157,-152.0,958,328.0,263.0,-133.0,91.0,69,23,46,3018,118,127,0,45.0,481,380,58.0,101,771,210,210.0,38.0,255,68.0,68.0,127,73.0,54,1176,0.0,0.0,2,2,1031.0,2282.0,-1477.0,4,4,1842,3018,153.3,153.3,38.5,1842,5900.0,157.0,198.0,958,133.0,5.0,4.3,67.0,60.0,20.0,91.0,380,22.0,21.0,17.0,48.0,1462,0.0,400.0,400.0,-593,556,600.0,15.0,15.0,30.0,60.0,68.0,45.0,128.0,412.0,59.0,-4.0,20.0,24.0,19.0,0.0,0.0,0.0,43.0,0.0,0.0,73.0,22.0,20.0,13.0,10.0,8.0,33.0,18.0,0.0,-14.0,89.0,249,128,128,-17,43,9.0,34,180,199,12,-10,-13,-8,583,-94,-37,-57,-49.0,-49.0,0.0,5.0,0.0,69.0,0.0,-143,22,22,-282.0,-282.0,-282.0,-19.0,0.0,-19.0,-19.0,-279,-8,153.0,695,848,4.0,124.0,180,489,89.0,667,667,667,317,317,350,181,181,46,0.0,0.0,6.0,544,123,-1.0,-1.0,0.0,1.0,-1.0,0.0,-1.0,0.0,0.0,123,29,94,94,-126.0,-126.0,94,94,94,154.5,0.61,0.61,0.3,94.3,157.1,0.6,0.6,0.0,0.0,0.0,7.0,7.0,0.0,123,0.0,29.0,94.0,94.0,0.61,0.6,12.0,32,4.0,1.0,1.0,12.0,11.0,126.0,46,123,167,1.0,1.0,2.0,0.0,-2.0,1.0,1.0,1.0,0.0,-1.0,2.0,2.0,3.0,0.0,-3.0,667,350,123,167,94,848,848,3018,255.0,1842,102,44,36,-86,66,0.0,0.6,157.1,,52.47,25.04,18.44,18.44,23.58,14.09,7.64,19.2,11.77,16.91,153.3,8.45,12.16,13.84,,1.0,0.0,6497.6,,5904.6,0.89,17.92,16.0,1.63,26.12,0.74,1.0,1.95,1.9,0.24,5.13,71.33,11.62,31.5,22.61,16.19,56.02,11500.0,0.45622435020519836,94,667,317,350,123,-0.06818181818181823,180,-593,3.6671815599240576,-0.03338599711977319,489,63.84364820846905,1176,1506,2282.0,2,3018,0.0,0.8208469055374593,1512,167.0,25.04,-0.023391812865497075,0.6,0.016949152542372836,14.09,-0.04081632653061229,52.47,0.0015015015015014122,18.44,36.0,11.77,19.2,0.89,1.95,11500.0,0.058,198.0,3.3686868686868685,2.6864406779661016,3.351758793969849,12300.0,61.0337972166998,0.010695652173913044,0.00817391304347826,181,848,255,-133.0,-152.0,1534.0,0.3375363724539282,123,0.4348109517601043,0.25337331334332835,43.721349083366434,43.325,3.49,8.58,0.24259500805152978,13.917035098585709,0.04638888888888889,0.03202254428341385,1.8123712303465878
2014-12,80.0,834,834,0.0,619,379.0,-4.0,619,3.0,38,21,17,81,44.0,214.0,81.0,1572,221.0,52.0,8.0,161.0,159,-152.0,948,335.0,269.0,-133.0,91.0,118,20,98,3132,126,165,220,53.0,431,370,58.0,61,995,195,195.0,38.0,468,86.0,86.0,149,99.0,50,1425,0.0,0.0,1,1,1054.0,656.0,0.0,-4,-4,1707,3132,147.9,147.9,0.0,1707,5900.0,159.0,199.0,948,133.0,5.0,4.3,67.0,60.0,20.0,91.0,370,18.0,21.0,17.0,48.0,1534,0.0,400.0,400.0,-366,424,600.0,15.0,15.0,30.0,60.0,68.0,45.0,128.0,412.0,59.0,-4.0,20.0,24.0,19.0,0.0,0.0,0.0,43.0,0.0,0.0,72.0,23.0,18.0,15.0,12.0,4.0,33.0,16.0,0.0,-14.0,80.0,367,169,169,-2,57,9.0,48,89,101,18,-23,-28,21,680,-129,-54,-75,-69.0,-69.0,0.0,5.0,0.0,69.0,0.0,-198,31,31,-551.0,-551.0,-551.0,194.0,220.0,-26.0,194.0,-326,-17,139.0,695,834,3.0,133.0,89,551,80.0,761,761,761,336,336,425,213,213,54,0.0,0.0,6.0,603,158,-1.0,-1.0,0.0,1.0,-1.0,0.0,-1.0,-1.0,-1.0,157,39,118,118,-126.0,-126.0,118,118,118,151.4,0.78,0.78,0.3,118.0,153.9,0.77,0.77,0.0,0.0,0.0,7.0,7.0,0.0,157,0.0,39.0,118.0,118.0,0.78,0.77,12.0,29,4.0,1.0,1.0,12.0,-2.0,126.0,54,158,199,1.0,1.0,2.0,0.0,-2.0,1.0,1.0,1.0,0.0,-1.0,2.0,2.0,3.0,0.0,-3.0,761,425,158,199,118,834,834,3132,468.0,1707,97,41,35,-14,62,0.0,0.77,153.9,,55.85,26.15,20.76,20.63,24.84,15.51,7.99,20.59,11.79,17.15,147.9,14.94,21.52,27.42,,1.0,0.0,6683.04,,6317.04,0.88,18.08,15.86,1.75,27.72,0.74,1.0,1.58,1.54,0.18,4.09,89.49,10.44,35.05,26.66,13.73,68.17,11500.0,0.49608865710560623,118,761,336,425,158,-0.10734463276836159,89,-366,3.61797206077401,-0.02553332738747993,551,83.47978910369068,1425,1572,656.0,1,3132,0.0,0.9138840070298769,1560,199.0,26.15,-0.07441860465116279,0.77,0.13235294117647056,15.51,0.0535714285714286,55.85,-0.01040312093628093,20.76,35.0,11.79,20.59,0.88,1.58,11500.0,0.06617391304347826,199.0,3.8241206030150754,2.6666666666666665,7.534653465346534,15800.0,54.50191570881226,0.013739130434782608,0.01026086956521739,213,834,468,-133.0,-152.0,1626.0,0.3057750759878419,158,0.46801968019680196,0.278580814717477,40.791798598026645,43.99,3.78,9.4,0.23756521739130432,13.79756595801104,0.04373913043478261,0.03191304347826087,1.8182514874664666
2015-03,73.0,881,881,0.0,583,379.0,-4.0,583,3.0,42,25,17,85,44.0,214.0,85.0,1591,221.0,52.0,8.0,161.0,162,-152.0,924,319.0,269.0,-147.0,91.0,107,19,88,3103,148,119,0,7.0,576,492,58.0,84,850,593,593.0,38.0,600,74.0,74.0,142,95.0,47,1659,0.0,0.0,1,1,1077.0,405.0,0.0,-39,-39,1444,3103,141.9,141.9,0.0,1444,5900.0,162.0,197.0,924,147.0,5.0,4.3,67.0,60.0,20.0,91.0,492,16.0,21.0,17.0,48.0,1549,0.0,400.0,400.0,-281,201,600.0,15.0,15.0,30.0,60.0,68.0,45.0,128.0,412.0,59.0,-4.0,20.0,24.0,19.0,0.0,0.0,0.0,43.0,0.0,0.0,72.0,23.0,18.0,15.0,12.0,4.0,33.0,16.0,0.0,-14.0,73.0,22,42,42,-6,17,0.0,17,147,37,-4,13,120,-19,222,-32,-17,-15,0.0,-69.0,0.0,5.0,0.0,69.0,0.0,-32,6,6,-269.0,-269.0,-269.0,133.0,600.0,-467.0,133.0,-130,-13,47.0,834,881,3.0,133.0,147,190,73.0,582,582,582,305,305,277,184,184,63,0.0,0.0,6.0,552,30,-1.0,-1.0,1.0,1.0,0.0,0.0,0.0,0.0,0.0,30,8,22,22,-126.0,-126.0,22,22,22,145.2,0.15,0.15,0.3,22.0,147.7,0.15,0.15,0.0,0.0,0.0,7.0,7.0,0.0,30,0.0,8.0,22.0,22.0,0.15,0.15,11.0,31,4.0,1.0,1.0,12.0,17.0,126.0,63,30,72,1.0,1.0,2.0,0.0,-2.0,1.0,1.0,1.0,0.0,-1.0,2.0,2.0,3.0,0.0,-3.0,582,277,30,72,22,881,881,3103,600.0,1444,222,42,32,47,190,0.0,0.15,147.7,,47.59,12.37,5.15,5.15,26.67,3.78,6.32,20.04,10.51,15.97,141.9,19.34,29.35,41.55,30.0,1.0,0.0,6406.92,,6125.92,0.86,16.46,14.07,1.91,26.84,0.75,1.0,1.87,1.82,0.24,4.51,81.08,10.31,35.5,30.07,12.17,57.75,11300.0,0.3757262750161394,22,582,305,277,30,-0.6629213483146068,147,-281,3.128279426293015,-0.14585597914385717,190,114.88919667590028,1659,1591,405.0,1,3103,0.0,1.0470914127423823,1512,72.0,12.37,-0.4461538461538461,0.15,-0.5945945945945946,3.78,-0.6271186440677966,47.59,-0.07324840764331209,5.15,32.0,10.51,20.04,0.86,1.87,11300.0,0.05150442477876106,197.0,2.954314720812183,2.060810810810811,15.72972972972973,0.0,46.535610699323236,0.002654867256637168,0.0019469026548672567,184,881,600,-147.0,-152.0,1462.0,0.3075857291305854,30,0.39808481532147744,0.15979381443298968,31.11043726974597,36.085,4.34,9.98,0.23446094651789146,13.596101784350862,0.038654867256637165,0.02872951135051943,1.7756345484019793
2015-06,76.0,921,921,0.0,511,379.0,-4.0,511,3.0,46,29,17,99,44.0,214.0,99.0,1577,221.0,52.0,8.0,161.0,160,-152.0,590,307.0,269.0,-156.0,91.0,101,19,82,2735,103,117,0,15.0,522,444,58.0,78,757,585,585.0,38.0,600,63.0,63.0,144,99.0,45,1549,0.0,0.0,1,1,1098.0,114.0,0.0,-27,-27,1186,2735,141.6,141.6,0.0,1186,5900.0,160.0,194.0,590,156.0,5.0,4.3,67.0,60.0,20.0,91.0,444,17.0,21.0,17.0,48.0,1531,0.0,400.0,400.0,-321,289,600.0,15.0,15.0,30.0,60.0,68.0,45.0,128.0,412.0,59.0,-4.0,20.0,24.0,19.0,0.0,0.0,0.0,43.0,0.0,0.0,72.0,23.0,18.0,15.0,12.0,4.0,33.0,16.0,0.0,-14.0,76.0,-243,84,84,-18,355,325.0,30,124,109,-8,-28,74,-23,302,-59,-29,-30,14.0,-69.0,14.0,5.0,0.0,69.0,0.0,-45,14,14,-308.0,-308.0,-308.0,133.0,600.0,-467.0,133.0,-161,-9,87.0,834,921,3.0,133.0,124,243,76.0,623,623,623,296,296,327,190,190,59,340.0,340.0,6.0,885,-262,-2.0,-2.0,16.0,1.0,15.0,0.0,14.0,-1.0,-1.0,-249,16,-265,-265,-126.0,-126.0,-265,-265,-265,141.9,-1.87,-1.87,0.3,-265.0,141.9,-1.87,-1.87,0.0,0.0,0.0,7.0,7.0,340.0,91,119.0,135.0,-44.0,-44.0,-0.31,-0.31,11.0,31,4.0,2.0,1.0,12.0,13.0,126.0,59,78,120,1.0,1.0,2.0,0.0,-2.0,1.0,1.0,1.0,0.0,-1.0,2.0,2.0,3.0,0.0,-3.0,623,327,78,120,-265,921,921,2735,600.0,1186,80,382,27,40,53,0.0,-1.87,141.9,,52.49,19.26,12.52,-39.97,,-42.54,6.68,-2.03,-1.06,,141.6,21.94,33.59,50.59,39.0,,,5254.0,,4933.0,0.9,2.32,2.08,1.93,4.0,-0.51,,2.08,2.02,0.3,4.96,73.74,11.67,31.38,26.13,14.01,56.38,11300.0,0.4069235793598955,-265,623,296,327,-262,-2.969924812030075,124,-321,3.3607521746495843,-0.06376447529466178,243,130.6070826306914,1549,1577,114.0,1,2735,-0.0,0.9763912310286678,1158,120.0,19.26,-0.31818181818181823,-1.87,-4.116666666666667,-42.54,-3.7604166666666665,52.49,-0.07840236686390534,12.52,27.0,-1.06,-2.03,0.9,2.08,11300.0,0.05513274336283186,194.0,3.211340206185567,2.8737864077669903,5.715596330275229,-1871.4285714285716,43.36380255941499,-0.023185840707964603,-0.023451327433628318,190,921,600,-156.0,-152.0,1173.0,0.29957643434732384,78,0.5311167945439045,0.21990369181380418,28.08916193893169,28.58,4.42,8.84,0.23081108118507115,13.358462398699693,0.003903809157368217,-0.0030696421700654106,1.832032241822288
2015-09,94.0,874,874,0.0,486,379.0,-4.0,486,3.0,52,35,17,102,44.0,214.0,102.0,1514,221.0,52.0,8.0,161.0,159,-152.0,587,309.0,280.0,-166.0,91.0,40,19,21,2609,111,124,110,23.0,470,387,58.0,83,838,577,577.0,38.0,710,60.0,60.0,138,96.0,42,1613,0.0,0.0,1,1,1116.0,-57.0,0.0,-64,-64,996,2609,133.9,133.9,0.0,996,5900.0,159.0,195.0,587,166.0,5.0,4.3,67.0,60.0,20.0,91.0,387,14.0,21.0,17.0,48.0,1462,0.0,400.0,400.0,-164,100,600.0,15.0,15.0,30.0,60.0,68.0,45.0,128.0,412.0,59.0,-4.0,20.0,24.0,19.0,0.0,0.0,0.0,43.0,0.0,0.0,72.0,23.0,18.0,15.0,12.0,4.0,33.0,16.0,0.0,-14.0,94.0,-165,129,129,-10,333,290.0,43,83,134,-14,-25,13,-25,370,-94,-43,-51,60.0,-9.0,14.0,5.0,0.0,69.0,0.0,-34,18,18,-541.0,-541.0,-541.0,243.0,710.0,-467.0,243.0,-280,-16,40.0,834,874,3.0,133.0,83,276,94.0,606,606,606,299,299,307,179,179,51,0.0,0.0,6.0,529,77,-3.0,-3.0,36.0,1.0,35.0,0.0,33.0,-1.0,-1.0,110,32,78,78,-126.0,-126.0,78,78,78,139.2,0.56,0.56,0.3,78.0,141.4,0.55,0.55,0.0,0.0,0.0,7.0,7.0,0.0,110,0.0,32.0,78.0,78.0,0.56,0.55,10.0,35,4.0,3.0,1.0,12.0,13.0,126.0,51,77,122,1.0,1.0,2.0,0.0,-2.0,1.0,1.0,1.0,0.0,-1.0,2.0,2.0,3.0,0.0,-3.0,606,307,77,122,78,874,874,2609,710.0,996,68,45,35,-47,33,0.0,0.55,141.4,,50.66,20.13,12.71,18.15,29.09,12.87,7.98,-3.31,-1.67,,133.9,27.21,41.62,71.29,25.67,1.0,0.0,4100.74,,3936.74,0.91,1.87,1.71,1.98,3.38,-0.98,,1.81,1.74,0.26,5.1,71.72,10.79,33.91,25.75,14.21,52.03,11300.0,0.41450068399452805,78,606,299,307,77,-0.3739837398373984,83,-164,3.4295331284928587,-0.06480410842710504,276,161.94779116465864,1613,1514,-57.0,1,2609,0.0,1.0993975903614457,1095,122.0,20.13,-0.2694610778443114,0.55,-0.08333333333333326,12.87,-0.17021276595744683,50.66,-0.09145427286356822,12.71,35.0,-1.67,-3.31,0.91,1.81,11300.0,0.0536283185840708,195.0,3.1076923076923078,2.6936936936936937,4.522388059701493,233.33333333333334,38.17554618627827,0.006814159292035399,0.006902654867256637,179,874,710,-166.0,-152.0,1150.0,0.2555886736214605,77,0.5269565217391304,0.21122112211221122,24.538900833181664,23.15,3.89,7.67,0.22643939976914196,13.097467837705134,2.231627549057185e-05,-0.004340900346287034,1.9241778118013144
2015-12,94.0,839,839,0.0,574,591.0,-17.0,580,6.0,49,32,17,266,44.0,214.0,52.0,1734,422.0,78.0,8.0,336.0,143,-279.0,380,212.0,92.0,-70.0,91.0,58,41,17,2527,96,155,180,30.0,492,367,58.0,67,953,567,567.0,38.0,777,28.0,28.0,130,89.0,41,1678,0.0,0.0,1,1,1128.0,-204.0,0.0,-76,-76,849,2527,130.7,130.7,0.0,849,5900.0,159.0,190.0,380,70.0,5.0,4.3,67.0,60.0,20.0,91.0,367,15.0,21.0,17.0,48.0,1685,0.0,400.0,400.0,-62,257,600.0,15.0,15.0,30.0,60.0,68.0,45.0,128.0,412.0,59.0,-4.0,20.0,24.0,19.0,0.0,0.0,0.0,43.0,0.0,0.0,72.0,23.0,18.0,15.0,12.0,4.0,33.0,16.0,0.0,-14.0,94.0,-214,170,170,-39,475,421.0,54,9,1,-11,-8,24,3,401,-120,-52,-68,68.0,-17.0,14.0,5.0,85.0,69.0,0.0,-52,20,20,-657.0,-657.0,-657.0,313.0,780.0,-467.0,313.0,-324,-20,5.0,834,839,3.0,133.0,9,281,94.0,719,719,719,354,354,365,212,212,55,138.0,138.0,6.0,759,-40,-3.0,-3.0,36.0,1.0,35.0,0.0,-3.0,8.0,8.0,-35,14,-49,-49,-126.0,-126.0,-49,-49,-49,132.1,-0.37,-0.37,0.0,-49.0,132.1,-0.37,-0.37,0.0,0.0,0.0,7.0,7.0,138.0,103,48.3,62.3,40.7,40.7,0.31,0.31,8.0,33,4.0,3.0,1.0,12.0,-4.0,126.0,55,98,139,1.0,1.0,2.0,0.0,-2.0,1.0,1.0,1.0,0.0,-1.0,2.0,2.0,3.0,0.0,-3.0,719,365,98,139,-49,839,839,2527,777.0,849,31,179,26,-35,5,0.0,-0.37,132.1,,50.76,19.33,13.63,-4.87,,-6.82,7.56,-16.74,-7.56,,130.7,30.75,47.79,91.52,32.67,,,3513.86,0.0,3451.86,0.89,-5.69,-5.09,2.21,-11.27,,,1.82,1.77,0.31,4.22,86.73,11.3,32.4,28.83,12.7,67.03,11300.0,0.42670623145400594,-49,719,354,365,-40,-1.2531645569620253,9,-62,4.530244218307269,0.25215013886483484,281,197.64428739693759,1678,1734,-204.0,1,2527,-0.0,0.934040047114252,793,139.0,19.33,-0.3015075376884422,-0.37,-1.4805194805194806,-6.82,-1.4152542372881356,50.76,-0.05519053876478319,13.63,26.0,-7.56,-16.74,0.89,1.82,11300.0,0.0636283185840708,190.0,3.7842105263157895,3.6875,719.0,-1333.3333333333335,33.59715077166601,-0.0035398230088495575,-0.004336283185840708,212,839,777,-70.0,-279.0,1136.0,0.2049239681390297,98,0.6329225352112676,0.21279554937413073,29.115649820915003,30.44,4.07,7.62,0.2238938053097345,13.057557761005848,-0.017256637168141593,-0.018938053097345132,2.08908066681578
2016-03,97.0,917,917,0.0,519,591.0,-17.0,519,6.0,54,37,17,187,44.0,139.0,48.0,1677,422.0,78.0,8.0,336.0,131,-279.0,384,207.0,77.0,-60.0,91.0,65,48,17,2464,83,118,80,30.0,657,506,55.0,96,968,560,560.0,38.0,670,20.0,20.0,122,81.0,41,1670,0.0,0.0,1,1,1158.0,-297.0,0.0,-68,-68,794,2464,129.4,129.4,0.0,794,5900.0,131.0,190.0,384,60.0,5.0,4.3,67.0,60.0,20.0,91.0,506,15.0,21.0,17.0,48.0,1623,0.0,400.0,400.0,-247,203,593.0,23.0,30.0,60.0,412.0,68.0,90.0,480.0,0.0,59.0,-4.0,20.0,24.0,19.0,0.0,0.0,0.0,43.0,0.0,0.0,72.0,23.0,18.0,15.0,12.0,4.0,33.0,16.0,0.0,-14.0,97.0,-46,34,34,-10,100,80.0,20,173,66,-5,-16,140,-12,251,-26,-8,-18,-3.0,-3.0,14.0,5.0,85.0,69.0,0.0,-29,8,8,-47.0,-47.0,-47.0,-107.0,0.0,-107.0,-107.0,-146,2,78.0,839,917,3.0,133.0,173,225,97.0,545,545,545,276,276,269,174,174,57,80.0,80.0,6.0,587,-42,-3.0,-3.0,0.0,0.0,35.0,0.0,-3.0,8.0,8.0,-45,1,-46,-46,-126.0,-126.0,-46,-46,-46,129.4,-0.36,-0.36,0.0,-46.0,129.4,-0.36,-0.36,0.0,0.0,0.0,7.0,7.0,80.0,35,28.0,29.0,6.0,6.0,0.05,0.05,5.0,29,4.0,3.0,1.0,12.0,21.0,126.0,57,38,72,1.0,1.0,2.0,0.0,-2.0,1.0,1.0,1.0,0.0,-1.0,2.0,2.0,3.0,0.0,-3.0,545,269,38,72,-46,917,917,2464,670.0,794,251,114,26,78,225,0.0,-0.36,129.4,,49.36,13.21,6.97,-8.26,,-8.44,8.84,-25.2,-10.13,,129.4,27.19,45.77,84.38,12.67,,,3382.8,,3135.8,0.9,-8.78,-7.87,2.49,-19.57,,,1.73,1.68,0.29,4.52,80.89,10.61,34.51,25.52,14.34,60.73,10093.0,0.33579790511398644,-46,545,276,269,-42,-2.4,173,-247,4.861668967462832,0.554103168214698,225,210.32745591939545,1670,1677,-297.0,1,2464,-0.0,0.9911838790931989,787,72.0,13.21,0.0,-0.36,-3.4,-8.44,-3.090909090909091,49.36,-0.06357388316151202,6.97,26.0,-10.13,-25.2,0.9,1.73,10093.0,0.05399782027147528,190.0,2.8684210526315788,3.325301204819277,8.257575757575758,-1400.0,32.22402597402597,-0.004161299910829287,-0.004557614188051125,174,917,670,-60.0,-279.0,886.0,0.24787052810902896,38,0.6151241534988713,0.1743119266055046,29.831260897724025,27.27,4.28,6.92,0.2263872008024487,12.971664092825243,-0.024072804335608048,-0.025442569940263515,2.306120004993174
2016-06,95.0,909,909,0.0,465,591.0,-17.0,465,6.0,37,21,16,184,44.0,130.0,54.0,1595,422.0,78.0,8.0,336.0,129,-279.0,384,207.0,77.0,-62.0,91.0,67,48,19,2382,104,125,0,30.0,560,430,43.0,87,819,552,552.0,38.0,582,17.0,17.0,130,88.0,42,1518,0.0,0.0,1,1,1178.0,-246.0,0.0,-69,-69,864,2382,129.5,129.5,0.0,864,5900.0,129.0,192.0,384,62.0,5.0,4.3,67.0,60.0,20.0,91.0,430,16.0,21.0,17.0,48.0,1558,0.0,400.0,400.0,-327,273,585.0,15.0,30.0,60.0,412.0,68.0,90.0,480.0,0.0,59.0,-4.0,20.0,24.0,19.0,0.0,0.0,0.0,43.0,0.0,0.0,72.0,23.0,18.0,15.0,12.0,4.0,33.0,16.0,0.0,-14.0,95.0,18,65,65,-15,111,80.0,31,171,122,11,-10,64,-16,350,-53,-17,-36,1.0,-4.0,14.0,5.0,85.0,69.0,0.0,-52,18,18,-51.0,-51.0,-51.0,-195.0,0.0,-195.0,-195.0,-228,0,70.0,839,909,3.0,133.0,171,297,95.0,599,599,599,289,289,310,172,172,51,0.0,0.0,6.0,512,87,-4.0,-4.0,2.0,2.0,35.0,0.0,-2.0,0.0,0.0,85,21,64,64,-126.0,-126.0,64,64,64,129.8,0.49,0.49,0.0,64.0,131.5,0.49,0.49,0.0,0.0,0.0,7.0,7.0,0.0,85,0.0,21.0,64.0,64.0,0.49,0.49,2.0,29,4.0,4.0,1.0,12.0,12.0,126.0,51,87,118,1.0,1.0,2.0,0.0,-2.0,1.0,1.0,1.0,0.0,-1.0,2.0,2.0,3.0,0.0,-3.0,599,310,87,118,64,909,909,2382,582.0,864,99,31,19,-8,72,0.0,0.49,131.5,,51.75,19.7,14.52,14.19,24.71,10.68,10.0,4.59,1.84,,129.5,24.43,40.25,67.36,21.75,1.0,0.0,3259.1,,2932.1,0.97,4.66,4.49,2.5,11.22,0.41,1.0,1.95,1.9,0.33,5.06,72.34,11.77,31.1,29.35,12.47,53.71,10093.0,0.38446726572528883,64,599,289,310,87,-1.33206106870229,171,-327,4.2189754425925825,0.2553664249380372,297,175.69444444444443,1518,1595,-246.0,1,2382,0.0,0.9108796296296297,787,118.0,19.7,-0.01666666666666672,0.49,-1.2620320855614973,10.68,-1.241509433962264,51.75,-0.038523274478330705,14.52,19.0,1.84,4.59,0.97,1.95,10093.0,0.05934806301397008,192.0,3.1197916666666665,2.7788461538461537,4.909836065573771,4350.0,36.272040302267,0.008619835529574953,0.00634102843554939,172,909,582,-62.0,-279.0,878.0,0.2925402242808386,87,0.6822323462414579,0.2303839732888147,28.083164733435986,29.69,3.76,6.5,0.23060252045358695,12.880115553306341,0.0077328719019315074,0.004349785928914193,2.457235556690727
2016-09,96.0,988,988,0.0,426,591.0,-17.0,426,6.0,44,29,15,59,44.0,0.0,59.0,1517,422.0,78.0,8.0,336.0,131,-279.0,396,206.0,77.0,-64.0,91.0,64,46,18,2314,93,125,0,30.0,440,361,0.0,79,688,545,545.0,38.0,575,20.0,20.0,129,88.0,41,1382,0.0,0.0,1,1,1203.0,-206.0,0.0,-66,-66,932,2314,129.8,129.8,0.0,932,5900.0,131.0,193.0,396,64.0,5.0,4.3,67.0,60.0,20.0,91.0,361,14.0,21.0,17.0,48.0,1473,0.0,400.0,400.0,-413,330,578.0,8.0,30.0,60.0,68.0,412.0,90.0,480.0,0.0,59.0,-4.0,20.0,24.0,19.0,0.0,0.0,0.0,43.0,0.0,0.0,72.0,23.0,18.0,15.0,12.0,4.0,33.0,16.0,0.0,-14.0,96.0,67,97,97,-9,126,80.0,46,114,162,4,-14,-7,-31,395,-86,-32,-54,81.0,-16.0,92.0,5.0,85.0,0.0,0.0,-5,27,27,-69.0,-69.0,-69.0,-202.0,0.0,-202.0,-202.0,-244,3,149.0,839,988,3.0,133.0,114,309,96.0,552,552,552,258,258,294,159,159,46,0.0,0.0,6.0,463,89,-3.0,-3.0,2.0,2.0,35.0,0.0,-1.0,2.0,2.0,90,41,49,49,-126.0,-126.0,49,49,49,129.7,0.38,0.38,0.0,49.0,131.6,0.37,0.37,0.0,0.0,0.0,7.0,7.0,0.0,90,0.0,41.0,49.0,49.0,0.38,0.37,2.0,30,4.0,3.0,1.0,12.0,16.0,126.0,46,89,121,1.0,1.0,2.0,0.0,-2.0,1.0,1.0,1.0,0.0,-1.0,2.0,2.0,3.0,0.0,-3.0,552,294,89,121,49,988,988,2314,575.0,932,45,32,33,79,12,0.0,0.37,131.6,,53.26,21.92,16.12,16.3,45.56,8.88,7.72,1.87,0.73,,129.8,24.85,38.16,61.7,29.67,1.0,0.0,4042.4,0.0,3629.4,0.98,3.93,3.86,2.55,9.85,0.19,1.0,2.2,2.14,0.36,5.3,69.11,11.54,31.72,24.52,14.93,52.32,10093.0,0.37474541751527496,49,552,258,294,89,0.1558441558441559,114,-413,4.240893924236267,0.23658053890850406,309,148.2832618025751,1382,1517,-206.0,1,2314,0.0,0.8551502145922747,797,121.0,21.92,-0.008196721311475419,0.37,-0.3272727272727274,8.88,-0.3717948717948718,53.26,-0.08910891089108908,16.12,33.0,0.73,1.87,0.98,2.2,10093.0,0.0546913702566135,193.0,2.860103626943005,2.774193548387097,3.4074074074074074,8900.0,40.276577355229044,0.008817992668185871,0.004854849895967502,159,988,575,-64.0,-279.0,862.0,0.3101391650099404,89,0.6403712296983759,0.24456521739130435,30.47427245480494,27.41,4.32,8.07,0.23166557212612962,12.63252687255704,0.00973670527808198,0.0023019809576250577,2.5706502646499727
2016-12,96.0,974,974,0.0,548,591.0,-17.0,548,6.0,34,20,14,65,44.0,0.0,65.0,1621,422.0,78.0,8.0,336.0,138,-279.0,390,198.0,77.0,-66.0,91.0,66,49,17,2413,103,139,0,30.0,457,369,0.0,88,729,538,538.0,38.0,568,33.0,33.0,142,96.0,46,1442,0.0,0.0,1,1,1220.0,-161.0,0.0,-89,-89,971,2413,130.6,130.6,0.0,971,5900.0,138.0,187.0,390,66.0,5.0,4.3,67.0,60.0,20.0,91.0,369,14.0,21.0,17.0,48.0,1587,0.0,400.0,400.0,-406,383,570.0,30.0,127.0,413.0,68.0,412.0,540.0,480.0,0.0,59.0,-4.0,20.0,24.0,19.0,0.0,0.0,0.0,43.0,0.0,0.0,72.0,23.0,18.0,15.0,12.0,4.0,33.0,16.0,0.0,-14.0,96.0,125,128,128,-3,140,78.0,62,56,40,14,11,1,-10,446,-118,-53,-65,83.0,-16.0,92.0,5.0,2.0,0.0,0.0,-35,30,30,-82.0,-82.0,-82.0,-210.0,0.0,-210.0,-210.0,-262,-14,135.0,839,974,3.0,133.0,56,328,96.0,626,626,626,311,311,315,159,159,58,0.0,0.0,6.0,528,98,-3.0,-3.0,2.0,2.0,35.0,0.0,-3.0,-4.0,-4.0,91,33,58,58,-126.0,-126.0,58,58,58,130.0,0.45,0.45,0.0,58.0,132.1,0.44,0.44,0.0,0.0,0.0,7.0,7.0,0.0,91,0.0,33.0,58.0,58.0,0.45,0.44,1.0,30,4.0,3.0,1.0,12.0,0.0,126.0,58,98,129,1.0,1.0,2.0,0.0,-2.0,1.0,1.0,1.0,0.0,-1.0,2.0,2.0,3.0,0.0,-3.0,626,315,98,129,58,974,974,2413,568.0,971,51,31,32,-14,19,0.0,0.44,132.1,,50.32,20.61,15.65,14.54,36.26,9.27,9.2,13.74,5.06,8.33,130.6,23.54,36.91,58.5,32.67,1.0,0.0,3529.38,0.0,3123.38,0.94,9.52,8.95,2.71,24.29,0.57,1.0,2.22,2.18,0.37,4.12,88.9,11.4,32.11,27.33,13.39,70.18,10093.0,0.39445494643982354,58,626,311,315,98,-3.45,56,-406,3.898078760781617,-0.13954335065888812,328,148.50669412976313,1442,1621,-161.0,1,2413,0.0,0.815653964984552,792,129.0,20.61,-0.07194244604316546,0.44,-2.1891891891891895,9.27,-2.183673469387755,50.32,-0.12934631432545207,15.65,32.0,5.06,13.74,0.94,2.22,10093.0,0.06202318438521748,187.0,3.3475935828877006,3.0194174757281553,15.65,3266.6666666666665,40.2403646912557,0.009709699791935004,0.005746557019716636,159,974,568,-66.0,-279.0,910.0,0.30498533724340177,98,0.6879120879120879,0.24920127795527156,29.115649820915003,30.44,3.65,7.1,0.23006043792727632,12.195909929128952,0.022986228078866543,0.012384821163182402,2.625639817350793
2017-03,95.0,1164,1164,0.0,442,591.0,-17.0,442,6.0,40,26,14,58,44.0,0.0,58.0,1704,422.0,78.0,8.0,336.0,142,-279.0,392,177.0,28.0,-18.0,91.0,68,50,18,2483,89,109,0,38.0,599,514,0.0,85,835,523,523.0,38.0,561,25.0,25.0,146,101.0,45,1529,0.0,0.0,1,1,1243.0,-207.0,0.0,-83,-83,954,2483,129.6,129.6,0.0,954,5900.0,142.0,167.0,392,18.0,5.0,4.3,67.0,60.0,20.0,91.0,514,14.0,21.0,17.0,48.0,1664,0.0,400.0,400.0,-603,385,570.0,30.0,127.0,413.0,68.0,412.0,540.0,480.0,0.0,59.0,-4.0,20.0,24.0,19.0,0.0,0.0,0.0,43.0,0.0,0.0,72.0,23.0,18.0,15.0,12.0,4.0,33.0,16.0,0.0,-14.0,95.0,-2,36,36,-8,16,0.0,16,206,106,-6,-44,145,5,248,-18,-16,-2,0.0,0.0,92.0,5.0,2.0,0.0,0.0,-18,7,7,-43.0,-43.0,-43.0,-8.0,0.0,-8.0,-8.0,-44,4,190.0,974,1164,3.0,133.0,206,230,95.0,491,491,491,267,267,224,155,155,70,0.0,0.0,6.0,492,-1,-3.0,-3.0,2.0,2.0,35.0,0.0,-1.0,0.0,0.0,-2,0,-2,-2,-126.0,-126.0,-2,-2,-2,130.4,-0.02,-0.02,0.0,-2.0,130.4,-0.02,-0.02,0.0,0.0,0.0,7.0,7.0,0.0,-2,0.0,0.0,-2.0,-2.0,-0.02,-0.02,2.0,34,4.0,3.0,1.0,12.0,16.0,126.0,70,-1,35,1.0,1.0,2.0,0.0,-2.0,1.0,1.0,1.0,0.0,-1.0,2.0,2.0,3.0,0.0,-3.0,491,224,-1,35,-2,1164,1164,2483,561.0,954,248,36,18,190,230,0.0,-0.02,130.4,,45.62,7.13,-0.2,-0.41,,-0.41,8.14,19.34,6.83,,129.6,22.59,37.03,58.81,-0.33,,,4073.22,,3470.22,0.92,11.64,10.67,2.83,30.21,0.64,1.0,2.04,1.99,0.35,4.72,77.54,13.07,28.0,23.91,15.3,64.84,10615.0,0.29507211538461536,-2,491,267,224,-1,-0.9761904761904762,206,-603,4.2566843640143555,-0.12443969498898266,230,160.27253668763103,1529,1704,-207.0,1,2483,-0.0,0.8165618448637316,779,35.0,7.13,-0.5138888888888888,-0.02,-0.9444444444444444,-0.41,-0.9565217391304348,45.62,-0.09908256880733946,-0.2,18.0,6.83,19.34,0.92,2.04,10615.0,0.04625529910504004,167.0,2.940119760479042,3.0,4.632075471698113,-100.0,38.42126459927507,-9.420631182289213e-05,-0.00018841262364578426,155,1164,561,-18.0,-279.0,648.0,0.3559322033898305,-1,0.7577160493827161,0.14052953156822812,31.14169389010502,28.43,4.23,8.55,0.22231791676084106,12.267608636976414,0.027053321677872937,0.01675402272758774,2.7682317132346377
2017-06,94.0,1085,1085,0.0,356,591.0,-17.0,356,6.0,42,29,13,65,44.0,0.0,65.0,1548,422.0,78.0,8.0,336.0,143,-279.0,401,171.0,41.0,-20.0,91.0,75,51,24,2338,97,129,0,45.0,521,431,0.0,90,792,508,508.0,38.0,553,14.0,14.0,152,107.0,45,1466,0.0,0.0,1,1,1266.0,-318.0,0.0,-77,-77,872,2338,126.3,126.3,0.0,872,5900.0,143.0,150.0,401,20.0,5.0,4.3,67.0,60.0,20.0,91.0,431,10.0,21.0,17.0,48.0,1506,0.0,400.0,400.0,-532,300,570.0,30.0,127.0,413.0,68.0,412.0,540.0,480.0,0.0,59.0,-4.0,20.0,24.0,19.0,0.0,0.0,0.0,43.0,0.0,0.0,72.0,23.0,18.0,15.0,12.0,4.0,33.0,16.0,0.0,-14.0,94.0,-6,70,70,-20,35,0.0,35,230,192,-8,-13,58,1,309,-34,-30,-4,-18.0,-18.0,92.0,0.0,2.0,0.0,0.0,-52,12,12,-151.0,-151.0,-151.0,-15.0,0.0,-15.0,-15.0,-154,8,111.0,974,1085,3.0,133.0,230,275,94.0,513,513,513,271,271,242,165,165,78,0.0,0.0,6.0,514,-1,-4.0,-4.0,3.0,3.0,35.0,0.0,-1.0,-1.0,-1.0,-3,1,-4,-4,-126.0,-126.0,-4,-4,-4,127.9,-0.03,-0.03,0.0,-4.0,127.9,-0.03,-0.03,0.0,0.0,0.0,7.0,7.0,0.0,-3,0.0,1.0,-4.0,-4.0,-0.03,-0.03,1.0,33,4.0,4.0,1.0,12.0,19.0,126.0,78,-1,33,1.0,1.0,2.0,0.0,-2.0,1.0,1.0,1.0,0.0,-1.0,2.0,2.0,3.0,0.0,-3.0,513,242,-1,33,-4,1085,1085,2338,553.0,872,61,34,16,-79,45,0.0,-0.03,127.9,,47.17,6.43,-0.19,-0.58,,-0.78,7.95,11.64,4.28,,126.3,23.65,38.81,63.42,-0.25,,,3813.06,0.0,3281.06,0.92,8.07,7.46,2.72,20.28,0.57,1.0,1.95,1.9,0.32,5.32,68.86,11.0,33.26,28.0,13.07,48.67,10615.0,0.34063745019920316,-4,513,271,242,-1,-1.0114942528735633,230,-532,5.269203120788485,0.24892955469551925,275,168.11926605504587,1466,1548,-318.0,1,2338,-0.0,0.9059633027522935,790,33.0,6.43,-0.7203389830508475,-0.03,-1.0612244897959184,-0.78,-1.0625,47.17,-0.1435726210350584,-0.19,16.0,4.28,11.64,0.92,1.95,10615.0,0.048327837965143665,150.0,3.42,2.7938144329896906,2.671875,-100.0,37.29683490162532,-9.420631182289213e-05,-0.00037682524729156853,165,1085,553,-20.0,-279.0,639.0,0.24390243902439024,-1,0.8028169014084507,0.15009746588693956,35.92451228559467,32.74,4.27,10.22,0.21129769171201465,12.567816970309748,0.01833927983647509,0.010036169044746784,2.8888162684016305
2017-09,85.0,1025,1025,0.0,366,591.0,-17.0,366,6.0,45,33,12,72,44.0,0.0,72.0,1508,422.0,78.0,8.0,336.0,159,-279.0,398,159.0,46.0,-23.0,91.0,83,53,30,2307,106,139,180,53.0,458,364,0.0,94,936,493,493.0,38.0,726,12.0,12.0,147,107.0,40,1588,0.0,0.0,1,1,1292.0,-505.0,0.0,-69,-69,719,2307,120.6,120.6,0.0,719,5900.0,159.0,136.0,398,23.0,5.0,4.3,67.0,60.0,20.0,91.0,364,17.0,21.0,17.0,48.0,1463,0.0,400.0,400.0,-299,162,570.0,30.0,127.0,413.0,68.0,412.0,540.0,480.0,0.0,59.0,-4.0,20.0,24.0,19.0,0.0,0.0,0.0,43.0,0.0,0.0,72.0,23.0,18.0,15.0,12.0,4.0,33.0,16.0,0.0,-14.0,85.0,7,103,103,-22,51,0.0,51,162,182,-11,0,-2,-7,301,-66,-59,-7,-18.0,-18.0,0.0,0.0,2.0,0.0,0.0,-84,20,20,-351.0,-351.0,-351.0,157.0,180.0,-23.0,157.0,-174,8,51.0,974,1025,3.0,133.0,162,235,85.0,526,526,526,276,276,250,161,161,80,0.0,0.0,6.0,517,9,-4.0,-4.0,3.0,3.0,35.0,0.0,-1.0,-2.0,-2.0,6,-7,13,13,-126.0,-126.0,13,13,13,123.5,0.11,0.11,0.0,13.0,128.9,0.1,0.1,0.0,0.0,0.0,7.0,7.0,0.0,6,0.0,-7.0,13.0,13.0,0.11,0.1,3.0,30,4.0,4.0,1.0,12.0,16.0,126.0,80,9,42,1.0,1.0,2.0,0.0,-2.0,1.0,1.0,1.0,0.0,-1.0,2.0,2.0,3.0,0.0,-3.0,526,250,9,42,13,1025,1025,2307,726.0,719,-8,33,32,-60,-40,0.0,0.1,128.9,,47.53,7.98,1.71,1.14,-116.67,2.47,5.79,7.87,2.81,9.77,120.6,31.47,50.24,100.97,2.25,1.0,0.0,4257.54,0.0,3958.54,0.93,4.27,3.98,2.8,11.14,0.71,1.0,1.61,1.56,0.25,5.44,67.22,11.29,32.43,25.24,14.5,49.3,10615.0,0.3595352016404648,13,526,276,250,9,-0.898876404494382,162,-299,6.698853360170403,0.5795852194951525,235,220.86230876216968,1588,1508,-505.0,1,2307,0.0,1.1112656467315716,799,42.0,7.98,-0.6528925619834711,0.1,-0.7297297297297297,2.47,-0.7346938775510203,47.53,-0.047101449275362306,1.71,32.0,2.81,7.87,0.93,1.61,10615.0,0.049552520018841265,136.0,3.8676470588235294,2.6037735849056602,2.89010989010989,900.0,31.16601647160815,0.0008478568064060292,0.0012246820536975977,161,1025,726,-23.0,-279.0,722.0,0.13257575757575757,9,0.7285318559556787,0.16920152091254753,38.99980215354267,38.82,5.67,16.29,0.2061588414742424,13.57536040219027,0.010369143974695249,0.006406001202476879,2.9769768946589332
2017-12,88.0,1089,1089,0.0,554,591.0,-17.0,554,6.0,30,18,12,77,44.0,0.0,77.0,1750,422.0,78.0,8.0,336.0,162,-279.0,399,144.0,43.0,-20.0,91.0,101,57,44,2556,74,173,240,60.0,516,414,0.0,102,1063,478,478.0,38.0,778,4.0,4.0,343,109.0,234,1888,0.0,0.0,1,1,1320.0,-579.0,0.0,-74,-74,668,2556,121.9,121.9,0.0,668,5900.0,162.0,121.0,399,20.0,5.0,4.3,67.0,60.0,20.0,91.0,414,85.0,21.0,17.0,48.0,1720,0.0,400.0,400.0,-311,125,570.0,30.0,127.0,413.0,68.0,412.0,540.0,480.0,0.0,59.0,-4.0,20.0,24.0,19.0,0.0,0.0,0.0,43.0,0.0,0.0,72.0,23.0,18.0,15.0,12.0,4.0,33.0,16.0,0.0,-14.0,88.0,-67,138,138,-34,68,0.0,68,219,-6,3,12,115,95,324,-87,-78,-9,-21.0,-21.0,0.0,0.0,0.0,0.0,0.0,-108,32,32,-351.0,-351.0,-351.0,210.0,420.0,-210.0,210.0,-109,8,115.0,974,1089,3.0,133.0,219,237,88.0,626,626,626,319,319,307,170,170,77,0.0,0.0,6.0,566,60,-4.0,-4.0,3.0,3.0,35.0,0.0,-1.0,-2.0,-2.0,57,5,52,52,-126.0,-126.0,-74,52,-74,121.3,0.43,-0.61,0.0,-74.0,121.3,0.43,-0.61,0.0,0.0,0.0,7.0,7.0,0.0,57,0.0,5.0,52.0,52.0,0.43,0.43,2.0,33,4.0,4.0,1.0,12.0,-4.0,126.0,77,60,95,1.0,1.0,2.0,0.0,-2.0,1.0,1.0,1.0,0.0,-1.0,2.0,2.0,3.0,0.0,-3.0,626,307,60,95,52,1089,1089,2556,778.0,668,23,35,21,64,2,0.0,0.43,121.3,,49.04,15.18,9.58,9.11,8.77,8.31,4.85,7.2,2.37,-3.47,121.9,30.44,53.8,116.47,15.0,1.0,0.0,4653.66,0.0,4342.66,0.87,2.69,2.33,3.03,7.08,1.02,1.0,1.65,1.62,0.27,3.91,93.54,12.79,28.61,35.38,10.35,75.27,10615.0,0.363953488372093,-74,626,319,307,60,-0.3877551020408163,219,-311,7.307528892174035,0.8746488566867174,237,282.63473053892216,1888,1750,-579.0,1,2556,0.0,1.2065868263473054,806,95.0,15.18,-0.26356589147286824,0.43,-0.022727272727272707,8.31,-2.2758620689655173,49.04,0.0,9.58,21.0,2.37,7.2,0.87,1.65,10615.0,0.058973151201130475,121.0,5.1735537190082646,4.3108108108108105,-104.33333333333333,6000.0,26.134585289514867,0.005652378709373528,-0.006971267074894018,170,1089,778,-20.0,-279.0,656.0,0.08556832694763729,60,0.9542682926829268,0.21884984025559107,40.24261582829559,40.25,7.02,21.08,0.2031088082901554,15.401320538310834,0.006311822892133773,-0.006311822892133775,3.2433330994297727
2018-03,89.0,939,939,0.0,471,591.0,-17.0,471,6.0,43,31,12,77,44.0,0.0,77.0,1530,422.0,78.0,8.0,336.0,172,-279.0,401,128.0,35.0,-14.0,91.0,124,58,66,2355,110,110,0,68.0,625,532,0.0,93,913,456,456.0,38.0,524,9.0,9.0,333,111.0,222,1711,0.0,0.0,1,1,1350.0,-637.0,0.0,-70,-70,644,2355,120.6,120.6,0.0,644,5900.0,172.0,107.0,401,14.0,5.0,4.3,67.0,60.0,20.0,91.0,532,72.0,21.0,17.0,48.0,1487,0.0,400.0,400.0,-415,115,570.0,30.0,127.0,413.0,68.0,412.0,540.0,480.0,0.0,59.0,-4.0,20.0,24.0,19.0,0.0,0.0,0.0,43.0,0.0,0.0,72.0,23.0,18.0,15.0,12.0,4.0,33.0,16.0,0.0,-14.0,89.0,-7,34,34,-5,19,0.0,19,143,83,-13,-27,124,-24,184,-28,-26,-2,-21.0,-21.0,0.0,0.0,0.0,0.0,0.0,-28,10,10,-60.0,-60.0,-60.0,-255.0,420.0,-255.0,-255.0,-305,0,-149.0,1089,940,3.0,133.0,143,156,89.0,506,506,506,283,283,223,152,152,75,0.0,0.0,6.0,510,-4,-5.0,-5.0,3.0,3.0,35.0,0.0,-2.0,-2.0,-2.0,-8,-1,-7,-7,-126.0,-126.0,-7,-7,-7,121.4,-0.06,-0.06,0.0,-7.0,121.4,-0.06,-0.06,0.0,0.0,0.0,7.0,7.0,0.0,-8,0.0,-1.0,-7.0,-7.0,-0.06,-0.06,2.0,32,4.0,5.0,1.0,12.0,19.0,126.0,75,-4,30,1.0,1.0,2.0,0.0,-2.0,1.0,1.0,1.0,0.0,-1.0,2.0,2.0,3.0,0.0,-3.0,506,223,-4,30,-7,939,939,2355,524.0,644,184,34,28,-149,156,0.0,-0.06,121.4,,44.07,5.93,-0.79,-1.58,,-1.38,3.29,6.76,2.23,,120.6,22.25,44.86,81.37,-0.8,,,4849.68,0.0,4434.68,0.9,2.4,2.15,3.03,6.51,1.04,1.0,1.68,1.63,0.26,4.76,76.96,11.54,31.72,27.66,13.23,58.47,10152.0,0.3402824478816409,-7,506,283,223,-4,3.0,143,-415,7.566918987076342,0.7776556446248226,156,265.68322981366464,1711,1530,-637.0,1,2355,-0.0,1.281055900621118,825,30.0,5.93,-0.1428571428571429,-0.06,2.0,-1.38,2.5,44.07,0.03054989816700604,-0.79,28.0,2.23,6.76,0.9,1.68,10152.0,0.04984239558707644,107.0,4.728971962616822,2.5727272727272728,6.096385542168675,-200.0,27.34607218683652,-0.0003940110323089047,-0.0006895193065405832,152,939,524,-14.0,-279.0,522.0,0.1094017094017094,-4,0.9693486590038314,0.14031620553359683,40.140822303765766,41.84,7.43,22.06,0.20669590477219182,17.190172740448617,0.006012018171647761,-0.006812929575028574,3.454965709050888
2018-06,92.0,882,882,0.0,379,591.0,-17.0,379,6.0,28,17,11,94,44.0,0.0,94.0,1383,422.0,78.0,8.0,336.0,187,-279.0,397,114.0,35.0,-16.0,91.0,122,54,68,2203,83,136,0,6.0,549,461,0.0,88,774,491,491.0,38.0,497,8.0,8.0,358,109.0,249,1631,0.0,0.0,1,1,1376.0,-714.0,0.0,-91,-91,572,2203,119.0,119.0,0.0,572,5900.0,187.0,95.0,397,16.0,5.0,4.3,67.0,60.0,10.0,91.0,461,109.0,21.0,17.0,48.0,1355,0.0,400.0,400.0,-385,61,570.0,30.0,127.0,413.0,68.0,412.0,540.0,480.0,0.0,59.0,-4.0,20.0,24.0,19.0,0.0,0.0,0.0,43.0,0.0,0.0,72.0,23.0,18.0,15.0,12.0,4.0,33.0,16.0,0.0,-14.0,92.0,-3,64,64,-6,35,0.0,35,200,185,2,-31,90,-46,290,-62,-58,-4,0.0,0.0,0.0,0.0,0.0,0.0,0.0,-62,18,18,-157.0,-157.0,-157.0,-280.0,420.0,-280.0,-280.0,-419,-15,-206.0,1089,883,3.0,133.0,200,228,92.0,544,544,544,294,294,250,163,163,77,0.0,0.0,6.0,534,10,-5.0,-5.0,4.0,4.0,35.0,0.0,-1.0,-3.0,-3.0,6,2,4,4,-126.0,-126.0,4,4,4,119.5,0.03,0.03,0.0,4.0,121.5,0.03,0.03,0.0,0.0,0.0,7.0,7.0,0.0,6,0.0,2.0,4.0,4.0,0.03,0.03,2.0,28,4.0,5.0,1.0,12.0,16.0,126.0,77,10,40,1.0,1.0,2.0,0.0,-2.0,1.0,1.0,1.0,0.0,-1.0,2.0,2.0,3.0,0.0,-3.0,544,250,10,40,4,882,882,2203,497.0,572,106,30,34,-57,72,0.0,0.03,121.5,,45.96,7.35,1.84,1.1,33.33,0.74,3.84,8.59,2.73,,119.0,22.56,46.49,86.89,2.0,1.0,0.0,4870.2,0.0,4485.2,0.97,2.77,2.69,3.14,8.45,1.02,1.0,1.79,1.75,0.28,5.99,61.08,13.01,28.13,33.46,10.94,43.89,10152.0,0.4014760147601476,4,544,294,250,10,-11.0,200,-385,7.63334933629523,0.44867243894613296,228,285.1398601398601,1631,1383,-714.0,1,2203,0.0,1.4335664335664335,820,40.0,7.35,0.21212121212121215,0.03,-2.0,0.74,-2.0,45.96,0.060428849902534054,1.84,34.0,2.73,8.59,0.97,1.79,10152.0,0.05358550039401103,95.0,5.726315789473684,3.5421686746987953,2.9405405405405407,1000.0,25.964593735814802,0.0009850275807722615,0.0003940110323089047,163,882,497,-16.0,-279.0,482.0,0.13380909901873328,10,1.1286307053941909,0.15992647058823528,36.53787297373114,35.49,8.35,21.56,0.21195356720105918,19.496488529922303,0.007091252064242914,-0.0060420932954281005,3.7807795130366277
2018-09,94.0,768,768,0.0,384,591.0,-17.0,384,6.0,45,33,12,87,44.0,0.0,87.0,1284,422.0,78.0,8.0,336.0,226,-279.0,396,101.0,35.0,-18.0,91.0,129,54,75,2136,95,147,0,13.0,470,384,0.0,86,725,484,484.0,38.0,497,4.0,4.0,363,109.0,254,1576,0.0,0.0,1,1,1397.0,-745.0,0.0,-93,-93,560,2136,118.1,118.1,0.0,560,5900.0,226.0,84.0,396,18.0,5.0,4.3,67.0,60.0,12.0,91.0,384,102.0,21.0,17.0,48.0,1239,0.0,400.0,400.0,-271,63,570.0,30.0,127.0,413.0,68.0,412.0,540.0,480.0,0.0,59.0,-4.0,20.0,24.0,19.0,0.0,0.0,0.0,43.0,0.0,0.0,72.0,23.0,18.0,15.0,12.0,4.0,33.0,16.0,0.0,-14.0,94.0,15,95,95,-11,50,0.0,50,108,182,-15,-8,7,-58,257,-97,-92,-5,0.0,0.0,0.0,0.0,0.0,0.0,0.0,-97,23,23,-206.0,-206.0,-206.0,-281.0,0.0,-281.0,-281.0,-464,-17,-321.0,1089,768,3.0,133.0,108,160,94.0,526,526,526,262,262,264,166,166,84,0.0,0.0,6.0,512,14,-6.0,-6.0,4.0,4.0,35.0,0.0,-2.0,-2.0,-2.0,10,-1,11,11,7.0,7.0,18,11,18,118.7,0.09,0.15,0.0,18.0,120.7,0.09,0.15,0.0,0.0,0.0,7.0,7.0,0.0,10,0.0,-1.0,11.0,11.0,0.09,0.09,1.0,30,4.0,6.0,1.0,12.0,15.0,-7.0,84,14,45,1.0,1.0,2.0,0.0,-2.0,1.0,1.0,1.0,0.0,-1.0,2.0,2.0,3.0,0.0,-3.0,526,264,14,45,11,768,768,2136,497.0,560,-33,31,35,-115,-68,0.0,0.09,120.7,,50.19,8.56,2.66,1.9,-10.0,2.09,3.54,9.38,2.7,-8.37,118.1,23.27,47.02,88.75,2.33,1.0,0.0,4491.26,,4220.26,0.99,2.95,2.93,3.47,10.16,0.92,1.0,1.77,1.71,0.26,5.87,62.33,11.52,31.76,25.73,14.22,44.79,10152.0,0.4245359160613398,18,526,262,264,14,0.5555555555555556,108,-271,9.498154042334024,0.41787758764918137,160,281.42857142857144,1576,1284,-745.0,1,2136,0.0,1.5214285714285714,852,45.0,8.56,0.0714285714285714,0.09,-0.10000000000000009,2.09,0.3846153846153846,50.19,0.0,2.66,35.0,2.7,9.38,0.99,1.77,10152.0,0.05181245074862096,84.0,6.261904761904762,2.7578947368421054,2.89010989010989,700.0,26.217228464419474,0.0013790386130811663,0.0017730496453900709,166,768,497,-18.0,-279.0,586.0,0.12232415902140673,14,0.8976109215017065,0.18631178707224336,44.8101622890232,42.86,7.95,20.1,0.21421349793083888,21.890746233003533,0.007622433870918052,-0.005493725703735627,3.9498585785826554
2018-12,93.0,715,715,0.0,602,591.0,-17.0,602,6.0,28,16,12,83,44.0,0.0,83.0,1428,422.0,78.0,8.0,336.0,295,-279.0,395,88.0,36.0,-20.0,91.0,154,67,87,2360,141,224,0,19.0,625,490,0.0,135,1009,478,478.0,38.0,497,3.0,3.0,375,113.0,262,1865,0.0,0.0,1,1,1418.0,-823.0,0.0,-101,-101,495,2360,116.8,116.8,0.0,495,5900.0,295.0,72.0,395,20.0,5.0,4.3,67.0,60.0,14.0,91.0,490,105.0,21.0,17.0,48.0,1400,0.0,400.0,400.0,-218,12,570.0,30.0,127.0,413.0,68.0,412.0,540.0,480.0,0.0,59.0,-4.0,20.0,24.0,19.0,0.0,0.0,0.0,43.0,0.0,0.0,72.0,23.0,18.0,15.0,12.0,4.0,33.0,16.0,0.0,-14.0,93.0,30,130,130,-18,65,0.0,65,157,-34,2,108,115,-34,364,-160,-153,-7,-3.0,-3.0,0.0,0.0,0.0,0.0,0.0,-163,31,31,-300.0,-300.0,-300.0,-285.0,0.0,-285.0,-285.0,-554,-20,-373.0,1089,716,23.0,33.0,157,204,93.0,588,588,588,299,299,289,185,185,81,0.0,0.0,6.0,565,23,-6.0,-6.0,3.0,3.0,35.0,0.0,-3.0,-1.0,-1.0,19,3,16,16,-1.0,-1.0,15,16,15,117.1,0.14,0.13,0.0,15.0,119.4,0.13,0.13,0.0,0.0,0.0,7.0,7.0,0.0,19,0.0,3.0,16.0,16.0,0.14,0.13,2.0,33,4.0,6.0,1.0,12.0,4.0,1.0,81,23,58,1.0,1.0,2.0,0.0,-2.0,1.0,1.0,1.0,0.0,-1.0,2.0,2.0,3.0,0.0,-3.0,588,289,23,58,16,715,715,2360,497.0,495,107,35,63,-52,44,0.0,0.13,119.4,,49.15,9.86,3.91,3.23,15.79,2.72,4.4,4.13,0.98,4.07,116.8,21.06,50.1,100.4,3.83,1.0,0.0,4534.15,0.0,4316.15,0.88,1.25,1.1,4.23,4.64,0.89,1.0,1.42,1.39,0.18,3.74,97.76,10.59,34.57,39.24,9.33,72.51,10152.0,0.42,15,588,299,289,23,-0.6166666666666667,157,-218,9.08934287862994,0.24383262970935782,204,376.7676767676768,1865,1428,-823.0,1,2360,0.0,1.8828282828282827,932,58.0,9.86,-0.3894736842105263,0.13,-0.6976744186046511,2.72,-1.2027027027027026,49.15,-0.060702875399361034,3.91,63.0,0.98,4.13,0.88,1.42,10152.0,0.057919621749408984,72.0,8.166666666666666,2.120567375886525,-17.294117647058822,766.6666666666667,20.97457627118644,0.0022655634357762015,0.0014775413711583924,185,715,497,-20.0,-279.0,576.0,0.0698051948051948,23,1.0208333333333333,0.17687074829931973,38.422072800357135,44.02,9.05,24.95,0.2131599684791174,24.883859180661936,0.004235618597320725,0.002955082742316783,4.016423619233063
2019-03,68.0,723,723,0.0,453,591.0,-17.0,453,6.0,52,40,12,74,44.0,0.0,74.0,1302,422.0,78.0,8.0,336.0,363,-279.0,396,74.0,35.0,-21.0,91.0,151,66,85,2286,99,120,0,46.0,649,569,0.0,80,914,510,472.0,38.0,556,4.0,4.0,391,104.0,287,1819,0.0,0.0,1,1,1466.0,-891.0,0.0,-109,-109,467,2286,117.1,117.1,0.0,467,5900.0,363.0,60.0,396,21.0,5.0,4.3,67.0,60.0,8.0,91.0,569,100.0,21.0,17.0,48.0,1250,0.0,400.0,400.0,-167,-3,570.0,30.0,127.0,413.0,68.0,412.0,540.0,480.0,0.0,59.0,-4.0,20.0,24.0,19.0,0.0,0.0,0.0,43.0,0.0,0.0,65.0,18.0,21.0,15.0,11.0,7.0,36.0,18.0,-7.0,-14.0,68.0,-10,37,37,2,15,0.0,15,5,143,-24,-171,74,-17,49,-16,-15,-1,-3.0,-3.0,0.0,0.0,0.0,0.0,0.0,-16,33,33,-56.0,-56.0,-56.0,-3.0,0.0,-3.0,-3.0,-26,1,8.0,716,724,23.0,33.0,5,33,68.0,468,468,468,244,244,224,151,151,78,0.0,0.0,6.0,473,-5,-9.0,-9.0,6.0,6.0,35.0,0.0,-3.0,-2.0,-2.0,-10,0,-10,-10,-1.0,-1.0,-10,-10,-10,117.1,-0.09,-0.09,0.0,-10.0,117.1,-0.09,-0.09,0.0,0.0,0.0,3.0,3.0,3.0,-7,0.0,0.0,-7.0,-7.0,-0.06,-0.06,12.0,25,4.0,9.0,1.0,12.0,15.0,1.0,78,-2,35,1.0,1.0,2.0,0.0,-2.0,1.0,1.0,1.0,0.0,-1.0,2.0,2.0,3.0,0.0,-3.0,468,224,-5,32,-10,723,723,2286,556.0,467,49,37,16,8,33,0.0,-0.09,117.1,33.0,47.86,6.84,-1.07,-2.14,,-2.14,1.55,3.78,0.9,,117.1,24.32,54.35,119.06,-0.56,,,5134.79,0.0,4967.79,0.92,1.18,1.08,4.18,4.5,0.84,1.0,1.42,1.37,0.17,4.6,79.54,10.52,34.8,23.14,15.82,60.55,8535.0,0.3744,-10,468,244,224,-5,0.25,5,-167,8.455502964756036,0.11743009000060933,33,389.5074946466809,1819,1302,-891.0,1,2286,-0.0,2.107066381156317,984,32.0,6.84,0.06666666666666665,-0.09,0.5,-2.14,0.4285714285714286,47.86,-0.07509881422924902,-1.07,16.0,0.9,3.78,0.92,1.42,8535.0,0.05483304042179262,60.0,7.8,2.4646464646464645,3.272727272727273,-166.66666666666669,20.428696412948383,-0.0005858230814294083,-0.0011716461628588166,151,723,556,-21.0,-279.0,600.0,0.08021390374331551,-2,0.78,0.15598290598290598,33.72092130265644,36.565,10.95,28.39,0.21815061331383356,27.954887218045112,0.004043806548200221,0.0024729558859985495,3.827074960229231
2019-06,51.0,635,635,0.0,383,591.0,-17.0,383,6.0,35,23,12,76,44.0,0.0,76.0,1129,422.0,78.0,8.0,336.0,375,-279.0,396,61.0,35.0,-23.0,91.0,162,70,92,2123,102,134,0,57.0,572,498,0.0,74,865,520,466.0,54.0,577,4.0,4.0,367,102.0,265,1756,0.0,0.0,1,1,1491.0,-1009.0,0.0,-116,-116,367,2123,114.1,114.1,0.0,367,5900.0,375.0,49.0,396,23.0,5.0,4.3,90.0,58.0,6.0,91.0,498,82.0,32.0,20.0,44.0,1094,0.0,400.0,400.0,-58,-90,570.0,30.0,127.0,413.0,68.0,412.0,540.0,480.0,0.0,86.0,-5.0,21.0,35.0,30.0,5.0,0.0,0.0,65.0,5.0,0.0,64.0,13.0,23.0,17.0,11.0,7.0,40.0,18.0,-7.0,-12.0,51.0,-11,77,77,0,37,0.0,37,1,211,-7,-155,-15,-33,104,-29,-27,-2,-3.0,-3.0,0.0,0.0,0.0,0.0,0.0,-29,36,36,-175.0,-175.0,-175.0,-15.0,0.0,-15.0,-15.0,-154,0,-79.0,716,637,23.0,33.0,1,75,51.0,478,478,478,242,242,236,145,145,81,0.0,0.0,6.0,468,10,-2.0,-2.0,0.0,0.0,35.0,0.0,-2.0,-3.0,-3.0,5,6,-1,-1,-1.0,-1.0,-1,-1,-1,112.6,-0.01,-0.01,0.0,-1.0,112.6,-0.01,-0.01,0.0,0.0,0.0,2.0,2.0,2.0,7,1.8,7.8,-0.8,-0.8,-0.01,-0.01,12.0,28,4.0,2.0,1.0,6.0,22.0,1.0,81,12,52,1.0,1.0,2.0,0.0,-2.0,1.0,1.0,1.0,0.0,-1.0,2.0,2.0,3.0,0.0,-3.0,478,236,10,50,-1,635,635,2123,577.0,367,55,40,13,-87,42,0.0,-0.01,115.5,42.0,49.37,10.46,2.09,1.05,120.0,-0.21,1.2,3.41,0.74,,114.1,27.18,61.12,157.22,1.25,,,4198.04,0.0,4140.04,0.95,1.17,1.11,4.61,5.11,0.67,1.0,1.31,1.26,0.12,5.41,67.69,11.32,32.34,33.24,11.01,46.37,8535.0,0.4369287020109689,-1,478,242,236,10,0.0,1,-58,8.350884675595431,0.09400006572323982,75,478.4741144414169,1756,1129,-1009.0,1,2123,-0.0,2.7084468664850134,994,50.0,10.46,0.25,-0.01,-1.3333333333333335,-0.21,-1.25,49.37,-0.12132352941176472,2.09,13.0,0.74,3.41,0.95,1.31,8535.0,0.056004686584651436,49.0,9.755102040816327,2.372549019607843,2.265402843601896,500.0,17.286858219500704,0.0011716461628588166,-0.00011716461628588167,145,635,577,-23.0,-279.0,611.0,0.08600182982616651,12,0.7823240589198036,0.1903765690376569,27.21824756610589,29.62,11.15,22.38,0.22056979950447397,31.983673469387753,0.0042304251302867765,0.001961780237403763,3.4807683137548433
2019-09,41.0,528,528,0.0,336,591.0,-17.0,336,6.0,36,24,12,78,44.0,0.0,78.0,978,422.0,78.0,8.0,336.0,386,-279.0,394,53.0,35.0,-24.0,91.0,168,67,101,1979,103,134,0,67.0,468,408,0.0,60,772,526,460.0,66.0,593,4.0,4.0,349,101.0,248,1651,0.0,0.0,1,1,1517.0,-1063.0,0.0,-127,-127,328,1979,112.4,112.4,0.0,328,5900.0,386.0,42.0,394,24.0,5.0,4.3,113.0,53.0,8.0,91.0,408,68.0,42.0,19.0,41.0,942,0.0,400.0,400.0,65,-119,570.0,30.0,127.0,413.0,68.0,412.0,540.0,480.0,0.0,108.0,-6.0,15.0,46.0,41.0,12.0,0.0,0.0,87.0,12.0,0.0,60.0,6.0,23.0,16.0,11.0,7.0,39.0,18.0,-3.0,-9.0,41.0,-1,113,113,1,59,0.0,59,-78,260,-8,-156,-119,-55,94,-46,-43,-3,-3.0,-3.0,0.0,0.0,0.0,0.0,0.0,-46,40,40,-239.0,-239.0,-239.0,-30.0,0.0,-30.0,-30.0,-229,-6,-187.0,716,529,23.0,33.0,-78,48,41.0,459,459,459,212,212,247,151,151,86,0.0,0.0,6.0,449,10,-8.0,-8.0,4.0,4.0,35.0,0.0,-4.0,-2.0,-2.0,4,-6,10,10,-1.0,-1.0,10,10,10,113.2,0.09,0.09,0.0,10.0,113.2,0.09,0.09,0.0,0.0,0.0,-1.0,-1.0,-1.0,3,-0.4,-6.4,9.4,9.4,0.08,0.08,7.0,29,7.0,8.0,1.0,6.0,22.0,1.0,86,9,45,1.0,1.0,2.0,0.0,-2.0,1.0,1.0,1.0,0.0,-1.0,2.0,2.0,3.0,0.0,-3.0,459,247,10,46,10,528,528,1979,593.0,328,-10,36,17,-108,-27,0.0,0.09,113.2,-27.0,53.81,10.02,2.18,0.87,-150.0,2.18,2.55,3.38,0.73,,112.4,29.96,64.39,180.79,1.25,1.0,0.0,3537.1,0.0,3602.1,0.97,0.9,0.87,4.63,4.05,0.83,1.0,1.27,1.22,0.1,5.54,66.11,10.07,36.34,24.62,14.87,44.64,8535.0,0.4872611464968153,10,459,212,247,10,-0.2857142857142857,-78,65,7.7133167050308336,-0.18791412829777543,48,503.3536585365853,1651,978,-1063.0,1,1979,0.0,3.051829268292683,1001,46.0,10.02,0.022222222222222143,0.09,0.0,2.18,-0.4444444444444444,53.81,-0.12737642585551334,2.18,17.0,0.73,3.38,0.97,1.27,8535.0,0.053778558875219686,42.0,10.928571428571429,2.058252427184466,1.7653846153846153,250.0,16.57402728650834,0.0011716461628588166,0.0011716461628588166,151,528,593,-24.0,-279.0,696.0,0.0655226209048362,9,0.6594827586206896,0.20915032679738563,22.34953956934729,26.53,10.62,19.37,0.2225359076310727,36.650340136054425,0.004023032680064427,0.001360376754872509,3.242640150873826
2019-12,31.0,494,494,0.0,406,591.0,-17.0,406,6.0,31,19,12,83,44.0,0.0,83.0,1014,422.0,78.0,8.0,336.0,401,-279.0,396,36.0,35.0,-24.0,91.0,119,87,32,2057,66,177,0,80.0,563,472,0.0,91,886,529,454.0,75.0,609,6.0,6.0,374,137.0,237,1795,0.0,0.0,1,1,1545.0,-1143.0,0.0,-141,-141,262,2057,110.9,110.9,0.0,262,5900.0,401.0,36.0,396,24.0,5.0,4.3,141.0,51.0,8.0,91.0,472,61.0,55.0,20.0,38.0,983,0.0,400.0,400.0,115,-170,570.0,30.0,127.0,413.0,68.0,412.0,540.0,480.0,0.0,130.0,-7.0,60.0,54.0,23.0,0.0,0.0,0.0,77.0,0.0,0.0,58.0,24.0,16.0,12.0,7.0,4.0,28.0,11.0,-5.0,-7.0,31.0,-20,150,150,-3,83,0.0,83,-62,190,-3,-153,-62,-34,148,-59,-54,-5,0.0,0.0,0.0,0.0,0.0,0.0,0.0,-59,44,44,-300.0,-300.0,-300.0,-52.0,0.0,-52.0,-52.0,-308,-1,-220.0,716,496,23.0,33.0,-62,89,31.0,494,494,494,246,246,248,171,171,82,0.0,0.0,6.0,499,-5,-7.0,-7.0,2.0,2.0,35.0,0.0,-5.0,-2.0,-2.0,-12,7,-19,-19,-1.0,-1.0,-19,-19,-19,111.2,-0.17,-0.17,0.0,-19.0,111.2,-0.17,-0.17,0.0,0.0,0.0,7.0,7.0,7.0,-5,2.5,9.5,-14.5,-14.5,-0.13,-0.13,8.0,29,9.0,7.0,1.0,7.0,14.0,1.0,82,2,39,1.0,1.0,2.0,0.0,-2.0,1.0,1.0,1.0,0.0,-1.0,2.0,2.0,3.0,0.0,-3.0,494,248,-5,32,-19,494,494,2057,609.0,262,54,37,13,-33,41,0.0,-0.17,111.2,41.0,50.2,6.48,-1.01,-2.43,,-3.85,2.91,-5.28,-0.91,,110.9,29.61,69.92,232.44,-0.71,,,3011.63,0.0,3126.63,0.86,-0.68,-0.59,5.83,-3.43,,,1.14,1.11,0.06,3.77,97.14,9.12,40.13,32.0,11.44,68.45,8535.0,0.5025432349949135,-19,494,246,248,-5,-1.2173913043478262,-62,115,9.296778504497622,0.0228218506703477,89,685.1145038167939,1795,1014,-1143.0,1,2057,-0.0,3.980916030534351,1043,32.0,6.48,-0.4482758620689655,-0.17,-2.3076923076923075,-3.85,-2.2666666666666666,50.2,-0.15986394557823125,-1.01,13.0,-0.91,-5.28,0.86,1.14,8535.0,0.05787932044522554,36.0,13.722222222222221,3.727272727272727,2.6,-100.0,12.73699562469616,-0.0005858230814294083,-0.0022261277094317517,171,494,609,-24.0,-279.0,680.0,0.03343949044585987,2,0.7264705882352941,0.15587044534412955,21.904280289373894,22.44,11.33,19.54,0.22249560632688925,42.205895691609975,0.0011716461628588169,-0.002343292325717635,2.9482774057757872
2020-03,46.0,394,394,0.0,457,591.0,-17.0,457,6.0,28,17,11,95,44.0,0.0,95.0,974,422.0,78.0,8.0,336.0,383,-279.0,394,30.0,35.0,-24.0,87.0,283,253,30,2151,96,103,0,85.0,622,555,0.0,67,906,523,448.0,75.0,608,6.0,6.0,367,133.0,234,1802,0.0,0.0,1,1,1567.0,-1050.0,0.0,-169,-169,349,2151,108.3,108.3,0.0,349,5900.0,383.0,30.0,394,24.0,5.0,4.3,141.0,49.0,9.0,87.0,555,44.0,60.0,17.0,37.0,946,0.0,400.0,400.0,214,-75,570.0,30.0,127.0,413.0,68.0,412.0,540.0,480.0,0.0,130.0,-7.0,60.0,54.0,23.0,0.0,0.0,0.0,77.0,0.0,0.0,58.0,24.0,16.0,12.0,7.0,4.0,28.0,11.0,-5.0,-7.0,46.0,168,42,42,-149,21,0.0,21,-72,-50,3,-43,66,-48,10,-12,-10,-2,0.0,0.0,0.0,0.0,0.0,0.0,0.0,-12,0,0,-73.0,-73.0,-73.0,-15.0,0.0,-15.0,-15.0,-88,-10,-100.0,496,396,23.0,33.0,-72,-2,46.0,434,434,434,209,209,225,158,158,73,0.0,0.0,6.0,440,-6,-7.0,-7.0,2.0,2.0,35.0,0.0,-5.0,-3.0,-3.0,-14,-182,168,168,-1.0,-1.0,168,168,168,110.3,1.52,1.52,0.0,168.0,111.3,1.51,1.51,0.0,0.0,0.0,0.0,0.0,0.0,-14,0.0,-182.0,168.0,168.0,1.52,1.51,6.0,36,9.0,7.0,1.0,7.0,21.0,1.0,73,-6,36,1.0,1.0,2.0,0.0,-2.0,1.0,1.0,1.0,0.0,-1.0,2.0,2.0,3.0,0.0,-3.0,434,225,-6,36,168,394,394,2151,608.0,349,10,42,12,-100,-2,0.0,1.51,111.3,,51.84,8.29,-1.38,-3.23,,38.71,2.34,38.73,7.12,,108.3,28.27,63.53,174.21,-0.86,1.0,0.0,2265.37,,2479.37,0.84,-0.91,-0.77,5.44,-4.17,,1.0,1.08,1.04,0.03,4.1,89.29,9.32,39.26,22.73,16.11,66.14,7543.0,0.4587737843551797,168,434,209,225,-6,0.19999999999999996,-72,214,7.0471148989229215,-0.16656467057057556,-2,516.3323782234957,1802,974,-1050.0,1,2151,0.0,3.372492836676218,1177,36.0,8.29,0.125,1.51,-17.77777777777778,38.71,-17.8,51.84,-0.07264957264957261,-1.38,12.0,7.12,38.73,0.84,1.08,7543.0,0.05753678907596447,30.0,14.466666666666667,2.1770833333333335,-8.68,-120.0,16.225011622501164,-0.0007954394803128729,0.02227230544876044,158,394,608,-24.0,-279.0,866.0,0.023192360163710776,-6,0.5011547344110855,0.1543778801843318,22.297761556882136,20.325,6.36,15.12,0.2251993549810611,48.872562358276646,0.0009620297639753523,0.021100659285901623,2.6694321401868724
2020-06,40.0,494,494,0.0,351,591.0,-17.0,351,6.0,26,14,12,77,44.0,0.0,77.0,948,422.0,78.0,8.0,336.0,383,-279.0,395,25.0,35.0,-24.0,88.0,263,236,27,2102,62,137,0,100.0,594,518,0.0,76,893,511,436.0,75.0,611,6.0,6.0,346,135.0,211,1756,0.0,0.0,1,1,1603.0,-1093.0,0.0,-165,-165,346,2102,108.9,108.9,0.0,346,5900.0,383.0,25.0,395,24.0,5.0,4.3,141.0,46.0,12.0,88.0,518,41.0,69.0,18.0,33.0,922,0.0,400.0,400.0,117,-74,570.0,30.0,127.0,413.0,68.0,412.0,540.0,480.0,0.0,130.0,-7.0,60.0,54.0,23.0,0.0,0.0,0.0,77.0,0.0,0.0,58.0,24.0,16.0,12.0,7.0,4.0,28.0,11.0,-5.0,-7.0,40.0,125,85,85,-149,52,0.0,52,27,59,5,-32,26,-31,140,-27,-23,-4,0.0,0.0,0.0,0.0,0.0,0.0,0.0,-27,6,6,-75.0,-75.0,-75.0,-38.0,0.0,-38.0,-38.0,-107,-7,-1.0,496,495,23.0,33.0,27,113,40.0,457,457,457,201,201,256,165,165,83,0.0,0.0,6.0,449,8,-7.0,-7.0,1.0,1.0,35.0,0.0,-6.0,-5.0,-5.0,-3,40,-43,-43,-1.0,-1.0,-43,-43,-43,108.5,-0.4,-0.4,0.0,-43.0,108.5,-0.4,-0.4,0.0,0.0,0.0,4.0,4.0,4.0,1,1.4,41.4,-40.4,-40.4,-0.37,-0.37,5.0,38,9.0,7.0,1.0,7.0,36.0,1.0,83,12,55,1.0,1.0,2.0,0.0,-2.0,1.0,1.0,1.0,0.0,-1.0,2.0,2.0,3.0,0.0,-3.0,457,256,8,51,-43,494,494,2102,611.0,346,130,43,15,99,115,0.0,-0.4,108.5,113.0,56.02,11.16,1.75,-0.66,,-9.41,5.5,32.54,5.49,,108.9,29.07,63.85,176.59,1.14,,,2256.8,0.0,2373.8,0.87,-1.36,-1.18,5.93,-7.01,,1.0,1.06,1.03,0.03,5.02,72.84,10.59,34.58,28.46,12.86,51.13,7543.0,0.4956616052060738,-43,457,201,256,8,-0.19999999999999996,27,117,6.6895654385889065,-0.19893931021003708,113,507.514450867052,1756,948,-1093.0,1,2102,-0.0,3.3352601156069364,1154,51.0,11.16,0.020000000000000018,-0.4,39.0,-9.41,42.0,56.02,-0.043933054393305415,1.75,15.0,5.49,32.54,0.87,1.06,7543.0,0.06058597375049715,25.0,18.28,3.2419354838709675,7.745762711864407,133.33333333333331,16.460513796384397,0.001060585973750497,-0.005700649608908922,165,494,611,-24.0,-279.0,766.0,0.024691358024691357,12,0.5966057441253264,0.19912472647702406,21.33262342628352,21.47,6.55,14.39,0.22978064214690683,57.397460317460315,0.0008509695748670325,0.015517174293278584,2.4837138253923956
2020-09,85.0,533,533,0.0,332,591.0,-17.0,332,6.0,14,3,11,86,44.0,0.0,86.0,965,422.0,78.0,8.0,336.0,378,-279.0,397,19.0,35.0,-24.0,89.0,269,238,31,2117,59,148,0,113.0,575,482,0.0,93,895,493,423.0,70.0,606,6.0,6.0,339,136.0,203,1733,0.0,0.0,1,1,1632.0,-1094.0,0.0,-155,-155,384,2117,109.2,109.2,0.0,384,5900.0,378.0,19.0,397,24.0,5.0,4.3,141.0,42.0,11.0,89.0,482,38.0,75.0,17.0,30.0,951,0.0,400.0,400.0,73,-32,570.0,30.0,127.0,413.0,68.0,412.0,540.0,480.0,0.0,130.0,-7.0,60.0,54.0,23.0,0.0,0.0,0.0,77.0,0.0,0.0,58.0,24.0,16.0,12.0,7.0,4.0,28.0,11.0,-5.0,-7.0,85.0,124,126,126,-152,79,0.0,79,34,77,17,-24,-13,-23,211,-40,-34,-6,0.0,0.0,0.0,0.0,0.0,0.0,0.0,-40,7,7,-75.0,-75.0,-75.0,-62.0,0.0,-62.0,-62.0,-130,-3,38.0,496,534,23.0,33.0,34,171,85.0,454,454,454,200,200,254,163,163,90,0.0,0.0,6.0,453,1,-7.0,-7.0,1.0,1.0,35.0,0.0,-6.0,-5.0,-5.0,-10,-9,-1,-1,-1.0,-1.0,-1,-1,-1,109.1,-0.01,-0.01,0.0,-1.0,109.1,-0.01,-0.01,0.0,0.0,0.0,12.0,12.0,12.0,2,4.2,-4.8,6.8,6.8,0.06,0.06,6.0,35,9.0,7.0,1.0,7.0,22.0,1.0,90,13,54,1.0,1.0,2.0,0.0,-2.0,1.0,1.0,1.0,0.0,-1.0,2.0,2.0,3.0,0.0,-3.0,454,254,1,42,-1,533,533,2117,606.0,384,71,41,13,39,58,0.0,-0.01,109.1,171.0,55.95,9.25,0.22,-2.2,,-0.22,8.49,29.49,5.13,,109.2,28.63,61.21,157.81,0.14,,,2474.3,,2547.3,0.9,-2.12,-1.9,5.75,-10.96,,1.0,1.08,1.06,0.03,5.51,66.47,10.57,34.63,34.24,10.69,42.53,7543.0,0.4773922187171398,-1,454,200,254,1,-0.9,34,73,11.456467433453854,0.48528420024315055,171,451.3020833333333,1733,965,-1094.0,1,2117,-0.0,3.0,1152,42.0,9.25,-0.08695652173913049,-0.01,-1.1111111111111112,-0.22,-1.1,55.95,-0.01089324618736387,0.22,13.0,5.13,29.49,0.9,1.08,7543.0,0.06018825401034071,19.0,23.894736842105264,3.389830508474576,5.896103896103896,16.666666666666664,18.138875767595657,0.00013257324671881213,-0.00013257324671881213,163,533,606,-24.0,-279.0,760.0,0.028846153846153848,13,0.5973684210526315,0.20044052863436124,40.32340508200074,25.32,6.46,15.82,0.23619033728202785,70.36362573099416,-0.00018810334127297202,0.014212954883700953,2.4215994878243374
2020-12,52.0,529,529,0.0,342,591.0,-17.0,342,6.0,29,18,11,144,44.0,0.0,144.0,1044,422.0,78.0,8.0,336.0,377,-279.0,401,19.0,35.0,-24.0,98.0,273,222,51,2193,50,185,0,119.0,598,499,0.0,99,952,481,411.0,70.0,600,6.0,6.0,354,152.0,202,1793,0.0,0.0,1,1,1656.0,-1114.0,0.0,-143,-143,400,2193,108.8,108.8,0.0,400,5900.0,377.0,19.0,401,24.0,5.0,4.3,141.0,38.0,11.0,98.0,499,38.0,75.0,15.0,28.0,1015,0.0,400.0,400.0,71,-1,570.0,30.0,127.0,413.0,68.0,412.0,540.0,480.0,0.0,130.0,-7.0,60.0,54.0,23.0,0.0,0.0,0.0,77.0,0.0,0.0,58.0,24.0,16.0,12.0,7.0,4.0,28.0,11.0,-5.0,-7.0,52.0,129,172,172,-118,101,0.0,101,-17,67,2,0,4,-90,267,-51,-44,-7,0.0,0.0,0.0,0.0,0.0,0.0,0.0,-51,9,9,-100.0,-100.0,-100.0,-95.0,0.0,-95.0,-95.0,-186,7,37.0,496,533,23.0,33.0,-17,216,52.0,491,491,491,207,207,284,183,183,88,0.0,0.0,6.0,478,13,-6.0,-6.0,0.0,0.0,35.0,0.0,-6.0,-4.0,-4.0,3,-2,5,5,-1.0,-1.0,5,5,5,109.3,0.05,0.05,0.0,5.0,113.7,0.04,0.04,0.0,0.0,0.0,-2.0,-2.0,-2.0,1,-0.7,-2.7,3.7,3.7,0.03,0.03,13.0,33,9.0,6.0,1.0,7.0,22.0,1.0,88,11,57,1.0,1.0,2.0,0.0,-2.0,1.0,1.0,1.0,0.0,-1.0,2.0,2.0,3.0,0.0,-3.0,491,284,13,59,5,529,529,2193,600.0,400,56,46,11,-1,45,0.0,0.04,113.7,45.0,57.84,12.02,2.65,0.61,-66.67,1.02,8.69,38.97,6.07,,108.8,27.36,60.0,150.0,2.17,1.0,0.0,2455.97,0.0,2526.97,0.86,-1.31,-1.13,6.42,-7.25,,1.0,1.1,1.07,0.04,4.91,74.56,14.09,25.98,27.23,13.44,62.01,7543.0,0.483743842364532,5,491,207,284,13,-3.6,-17,71,12.72142043380009,0.36836866960374337,216,448.25,1793,1044,-1114.0,1,2193,0.0,2.8725,1149,59.0,12.02,0.84375,0.04,-1.2352941176470589,1.02,-1.263157894736842,57.84,-0.006072874493927127,2.65,11.0,6.07,38.97,0.86,1.1,7543.0,0.06509346413893677,19.0,25.842105263157894,4.14,7.3283582089552235,216.66666666666666,18.23985408116735,0.0017234522073445579,0.0006628662335940607,183,529,600,-24.0,-279.0,774.0,0.04126547455295736,11,0.6343669250645995,0.20570264765784113,46.55597596999118,39.91,6.11,13.44,0.24340448097573905,82.48350877192982,0.002121171947500994,0.017101948826726766,2.329495824653643
2021-03,82.0,538,538,0.0,386,591.0,-17.0,386,6.0,16,6,10,135,44.0,0.0,135.0,1075,422.0,78.0,8.0,336.0,378,-279.0,399,19.0,35.0,-24.0,99.0,252,209,43,2203,55,120,0,142.0,638,557,0.0,81,955,483,399.0,84.0,625,7.0,7.0,341,143.0,198,1786,0.0,0.0,1,1,1708.0,-1146.0,0.0,-146,-146,417,2203,109.4,109.4,0.0,417,5900.0,378.0,19.0,399,24.0,5.0,4.3,141.0,34.0,19.0,99.0,557,43.0,92.0,14.0,26.0,1059,0.0,400.0,400.0,87,18,570.0,30.0,127.0,413.0,68.0,412.0,540.0,480.0,0.0,130.0,-7.0,60.0,54.0,23.0,0.0,0.0,0.0,77.0,0.0,0.0,58.0,24.0,16.0,12.0,7.0,4.0,28.0,11.0,-5.0,-7.0,82.0,53,39,39,10,21,0.0,21,-13,-36,13,-44,63,-9,110,-5,-4,-1,0.0,0.0,0.0,0.0,0.0,0.0,0.0,-5,13,13,-83.0,-83.0,-83.0,-21.0,0.0,-21.0,-21.0,-91,-5,9.0,533,542,23.0,33.0,-13,105,82.0,491,491,491,184,184,307,149,149,77,0.0,0.0,6.0,410,81,-7.0,-7.0,1.0,1.0,35.0,0.0,-6.0,-3.0,-3.0,72,19,53,53,-1.0,-1.0,53,53,53,108.7,0.49,0.49,0.0,53.0,112.8,0.47,0.47,0.0,0.0,0.0,5.0,5.0,5.0,77,1.3,20.3,56.7,56.7,0.52,0.5,13.0,39,9.0,7.0,1.0,7.0,21.0,1.0,77,86,125,1.0,1.0,2.0,0.0,-2.0,1.0,1.0,1.0,0.0,-1.0,2.0,2.0,3.0,0.0,-3.0,491,307,81,120,53,538,538,2203,625.0,417,110,39,5,9,105,0.0,0.47,112.8,105.0,62.53,24.44,16.5,14.66,26.39,10.79,7.55,3.66,0.64,,109.4,28.37,59.98,149.88,11.57,1.0,0.0,4240.48,,4327.48,0.87,3.28,2.85,5.68,16.19,0.23,1.0,1.13,1.11,0.05,4.49,81.49,10.49,34.89,36.0,10.17,56.77,7200.0,0.4636449480642115,53,491,184,307,81,-14.5,-13,87,13.450060375625329,0.9085910430779311,105,428.2973621103117,1786,1075,-1146.0,1,2203,0.0,2.7050359712230216,1128,120.0,24.44,2.3333333333333335,0.47,-0.6887417218543046,10.79,-0.6845238095238095,62.53,0.13133640552995396,16.5,5.0,0.64,3.66,0.87,1.13,7200.0,0.06819444444444445,19.0,25.842105263157894,3.3454545454545452,-13.63888888888889,1350.0,18.92873354516568,0.01125,0.007361111111111111,149,538,625,-24.0,-279.0,807.0,0.14584578601315004,86,0.6084262701363073,0.32179226069246436,51.5977477151404,48.76,10.11,15.91,0.25406213634421904,93.85894736842106,0.014166611427813867,0.002190754489077438,2.4367673603788647
2021-06,90.0,684,684,0.0,315,591.0,-17.0,315,6.0,20,10,10,127,44.0,0.0,127.0,1146,422.0,78.0,8.0,336.0,352,-279.0,399,19.0,35.0,-24.0,97.0,251,208,43,2245,91,132,0,149.0,626,544,0.0,82,998,447,374.0,73.0,596,6.0,6.0,323,143.0,180,1774,0.0,0.0,1,1,1743.0,-1138.0,0.0,-135,-135,471,2245,108.9,108.9,0.0,471,5900.0,352.0,19.0,399,24.0,5.0,4.3,141.0,27.0,16.0,97.0,544,41.0,87.0,13.0,20.0,1126,0.0,400.0,400.0,-88,72,570.0,30.0,127.0,413.0,68.0,412.0,540.0,480.0,0.0,130.0,-7.0,60.0,54.0,23.0,0.0,0.0,0.0,77.0,0.0,0.0,58.0,24.0,16.0,12.0,7.0,4.0,28.0,11.0,-5.0,-7.0,90.0,97,76,76,9,52,0.0,52,101,32,9,15,48,-3,335,-11,-9,-2,0.0,0.0,0.0,0.0,0.0,0.0,0.0,-11,18,18,-121.0,-121.0,-121.0,-63.0,0.0,-63.0,-63.0,-166,-4,154.0,533,687,23.0,33.0,101,324,90.0,491,491,491,181,181,310,161,161,79,0.0,0.0,6.0,421,70,-7.0,-7.0,2.0,2.0,35.0,0.0,-5.0,-6.0,-6.0,59,15,44,44,-1.0,-1.0,44,44,44,109.0,0.4,0.4,0.0,44.0,112.7,0.39,0.39,0.0,0.0,0.0,3.0,3.0,3.0,62,0.8,15.8,46.2,46.2,0.42,0.41,13.0,37,9.0,7.0,1.0,7.0,31.0,1.0,79,73,110,1.0,1.0,2.0,0.0,-2.0,1.0,1.0,1.0,0.0,-1.0,2.0,2.0,3.0,0.0,-3.0,491,310,70,107,44,684,684,2245,596.0,471,225,37,6,145,219,0.0,0.39,112.7,219.0,63.14,21.79,14.26,12.02,25.42,8.96,7.62,24.72,4.65,,108.9,26.55,55.86,126.54,10.0,1.0,0.0,5476.71,,5388.71,0.89,6.43,5.71,5.32,30.35,0.81,1.0,1.15,1.13,0.07,5.79,63.25,10.09,36.27,33.57,10.9,37.88,7200.0,0.436056838365897,44,491,181,310,70,7.75,101,-88,11.304347825809838,0.6898478577697225,324,376.6454352441614,1774,1146,-1138.0,1,2245,0.0,2.3333333333333335,1099,107.0,21.79,1.0980392156862746,0.39,-1.975,8.96,-2.0232558139534884,63.14,0.07439824945295404,14.26,6.0,4.65,24.72,0.89,1.15,7200.0,0.06819444444444445,19.0,25.842105263157894,1.989010989010989,15.34375,1400.0,20.979955456570156,0.009722222222222222,0.006111111111111111,161,684,596,-24.0,-279.0,686.0,0.25206611570247933,73,0.7157434402332361,0.3034623217922607,48.8472277610682,56.7,11.55,16.43,0.26167060703816636,101.42105263157895,0.022828247676285593,0.014002515209097472,2.5559050564867745
2021-09,80.0,613,613,0.0,302,591.0,-17.0,302,6.0,17,7,10,132,44.0,0.0,132.0,1064,422.0,78.0,8.0,336.0,329,-279.0,397,19.0,35.0,-24.0,99.0,245,205,40,2134,104,150,0,156.0,545,464,0.0,81,955,407,349.0,58.0,563,8.0,8.0,307,141.0,166,1677,0.0,0.0,1,1,1776.0,-1179.0,0.0,-141,-141,457,2134,108.4,108.4,0.0,457,5900.0,329.0,19.0,397,24.0,5.0,4.3,141.0,29.0,12.0,99.0,464,28.0,81.0,13.0,20.0,1047,0.0,400.0,400.0,-50,60,570.0,30.0,127.0,413.0,68.0,412.0,540.0,480.0,0.0,130.0,-7.0,60.0,54.0,23.0,0.0,0.0,0.0,77.0,0.0,0.0,58.0,24.0,16.0,12.0,7.0,4.0,28.0,11.0,-5.0,-7.0,80.0,114,113,113,10,79,0.0,79,52,41,12,45,-45,-1,368,-21,-19,-2,0.0,0.0,0.0,0.0,0.0,0.0,0.0,-21,24,24,-176.0,-176.0,-176.0,-100.0,0.0,-100.0,-100.0,-252,-11,84.0,533,617,23.0,33.0,52,347,80.0,460,460,460,185,185,275,166,166,79,0.0,0.0,6.0,430,30,-6.0,-6.0,1.0,1.0,35.0,0.0,-5.0,-6.0,-6.0,19,2,17,17,-1.0,-1.0,17,17,17,108.9,0.16,0.16,0.0,17.0,113.4,0.15,0.15,0.0,0.0,0.0,3.0,3.0,3.0,22,0.3,2.3,19.7,19.7,0.18,0.17,13.0,37,9.0,6.0,1.0,7.0,27.0,1.0,79,33,70,1.0,1.0,2.0,0.0,-2.0,1.0,1.0,1.0,0.0,-1.0,2.0,2.0,3.0,0.0,-3.0,460,275,30,67,17,613,613,2134,563.0,457,33,37,10,-70,23,0.0,0.15,113.4,23.0,59.78,14.57,6.52,4.13,10.53,3.7,6.04,28.3,5.6,,108.4,26.38,55.2,123.19,5.0,1.0,0.0,6256.89,,6206.89,0.91,7.92,7.2,5.05,36.39,0.78,1.0,1.11,1.1,0.05,6.1,60.02,9.29,39.4,48.84,7.49,28.11,7200.0,0.4393505253104107,17,460,185,275,30,29.0,52,-50,11.03095376531903,-0.037141786559117596,347,366.95842450765866,1677,1064,-1179.0,1,2134,0.0,2.341356673960613,1070,67.0,14.57,0.5952380952380953,0.15,-16.0,3.7,-18.0,59.78,0.013215859030837107,6.52,10.0,5.6,28.3,0.91,1.11,7200.0,0.06388888888888888,19.0,24.210526315789473,1.7788461538461537,11.21951219512195,600.0,21.415182755388944,0.004166666666666667,0.002361111111111111,166,613,563,-24.0,-279.0,710.0,0.2761904761904762,33,0.647887323943662,0.23695652173913043,46.291513964653774,42.495000000000005,13.6,17.58,0.2653712419167145,101.73684210526315,0.026862341096233446,0.016496199566927394,2.606423959377805
2021-12,93.0,592,592,0.0,346,591.0,-17.0,346,6.0,26,17,9,142,44.0,0.0,142.0,1106,422.0,78.0,8.0,336.0,314,-279.0,396,19.0,35.0,-24.0,111.0,242,202,40,2169,67,160,0,165.0,641,552,0.0,89,1033,377,324.0,53.0,542,7.0,7.0,292,138.0,154,1709,0.0,0.0,1,1,1808.0,-1211.0,0.0,-138,-138,460,2169,107.2,107.2,0.0,460,5900.0,314.0,19.0,396,24.0,5.0,4.0,141.0,26.0,10.0,111.0,552,27.0,77.0,12.0,18.0,1080,0.0,400.0,400.0,-50,64,570.0,30.0,127.0,413.0,68.0,412.0,540.0,480.0,0.0,130.0,-7.0,60.0,54.0,23.0,0.0,0.0,0.0,77.0,0.0,0.0,58.0,24.0,16.0,12.0,7.0,4.0,28.0,11.0,-5.0,-7.0,93.0,147,149,149,14,112,0.0,112,41,-5,3,17,42,-16,463,-31,-28,-3,0.0,0.0,0.0,0.0,0.0,0.0,0.0,-31,24,24,-244.0,-244.0,-244.0,-136.0,0.0,-136.0,-136.0,-356,-14,62.0,533,595,23.0,33.0,41,432,93.0,475,475,475,181,181,294,170,170,74,0.0,0.0,6.0,425,50,-6.0,-6.0,2.0,2.0,35.0,0.0,-4.0,-4.0,-4.0,42,9,33,33,-1.0,-1.0,33,33,33,107.7,0.31,0.31,0.0,33.0,112.3,0.29,0.29,0.0,0.0,0.0,0.0,0.0,0.0,42,0.0,9.0,33.0,33.0,0.31,0.29,13.0,36,9.0,6.0,1.0,7.0,33.0,1.0,74,50,86,1.0,1.0,2.0,0.0,-2.0,1.0,1.0,1.0,0.0,-1.0,2.0,2.0,3.0,0.0,-3.0,475,294,50,86,33,592,592,2169,542.0,460,95,36,10,-22,85,0.0,0.29,112.3,85.0,61.89,18.11,10.53,8.84,21.43,6.95,9.02,34.19,6.74,16.67,107.2,24.99,54.09,117.83,8.33,1.0,0.0,4608.0,,4558.0,0.88,10.02,8.8,5.07,44.65,0.77,1.0,1.07,1.05,0.03,5.57,65.68,12.5,29.29,26.58,13.77,50.16,7200.0,0.4398148148148148,33,475,181,294,50,2.8461538461538463,41,-50,9.281959893363863,-0.27036764945664205,432,371.5217391304348,1709,1106,-1211.0,1,2169,0.0,2.3108695652173914,1063,86.0,18.11,0.4576271186440677,0.29,6.249999999999999,6.95,5.6,61.89,-0.03258655804480648,10.53,10.0,6.74,34.19,0.88,1.07,7200.0,0.06597222222222222,19.0,25.0,2.701492537313433,-95.0,1250.0,21.207929921622867,0.006944444444444444,0.004583333333333333,170,592,542,-24.0,-279.0,713.0,0.32548755884330866,50,0.6661991584852734,0.26105263157894737,39.64439694472959,45.73,9.9,11.99,0.26625,100.89473684210526,0.03208333333333333,0.020416666666666666,2.6382561927984787
2022-03,94.0,404,404,0.0,347,591.0,-17.0,347,6.0,16,7,9,96,44.0,0.0,96.0,863,422.0,78.0,8.0,336.0,296,-279.0,395,19.0,35.0,-24.0,109.0,232,200,32,1895,78,102,0,151.0,662,580,0.0,82,993,380,324.0,56.0,531,16.0,16.0,269,133.0,136,1658,0.0,0.0,1,1,1792.0,-1425.0,0.0,-131,-131,237,1895,104.7,104.7,0.0,237,5900.0,296.0,19.0,395,24.0,5.0,4.0,141.0,22.0,17.0,109.0,580,19.0,76.0,11.0,15.0,847,0.0,400.0,400.0,127,-158,570.0,30.0,127.0,413.0,68.0,412.0,540.0,480.0,0.0,130.0,-7.0,60.0,54.0,23.0,0.0,0.0,0.0,77.0,0.0,0.0,58.0,24.0,16.0,12.0,7.0,4.0,28.0,11.0,-5.0,-7.0,94.0,36,40,40,8,31,0.0,31,36,6,10,-49,20,49,151,-1,-1,0,0.0,0.0,0.0,0.0,0.0,0.0,0.0,-1,4,4,-300.0,-300.0,-300.0,-35.0,0.0,-35.0,-35.0,-331,-6,-187.0,595,408,23.0,33.0,36,150,94.0,496,496,496,195,195,301,157,157,76,0.0,0.0,6.0,428,68,-6.0,-6.0,2.0,2.0,35.0,0.0,-4.0,-9.0,-9.0,55,19,36,36,-1.0,-1.0,36,36,36,105.0,0.34,0.34,0.0,36.0,108.6,0.33,0.33,0.0,0.0,0.0,6.0,6.0,6.0,61,2.1,21.1,39.9,39.9,0.38,0.37,13.0,40,9.0,6.0,1.0,7.0,31.0,1.0,76,74,114,1.0,1.0,2.0,0.0,-2.0,1.0,1.0,1.0,0.0,-1.0,2.0,2.0,3.0,0.0,-3.0,496,301,68,108,36,404,404,1895,531.0,237,151,40,1,-187,150,0.0,0.33,108.6,150.0,60.69,21.77,13.71,11.09,34.55,7.26,8.66,39.76,6.34,16.43,104.7,28.02,69.14,224.05,11.33,1.0,0.0,5156.72,,5283.72,0.94,9.11,8.54,6.27,53.52,0.74,1.0,0.87,0.85,-0.07,5.24,69.79,11.16,32.8,46.38,7.89,44.88,,0.5855962219598583,36,496,195,301,68,-0.16049382716049387,36,127,17.02061426928125,0.26546749932265024,150,699.57805907173,1658,863,-1425.0,1,1895,0.0,4.3544303797468356,1032,108.0,21.77,-0.09999999999999998,0.33,-0.2978723404255318,7.26,-0.3207547169811321,60.69,0.010183299389002087,13.71,1.0,6.34,39.76,0.94,0.87,,,19.0,26.105263157894736,2.5,82.66666666666667,1700.0,12.506596306068602,,,157,404,531,-24.0,-279.0,667.0,0.3120759837177748,74,0.7436281859070465,0.2903225806451613,38.417957922091965,38.51,21.77,14.36,0.19805555555555554,101.1578947368421,0.020833333333333332,0.013055555555555556,2.7734581085692183
